//MAP CONVERTED BY dmm2tgm.py THIS HEADER COMMENT PREVENTS RECONVERSION, DO NOT REMOVE
"aq" = (
/obj/effect/turf_decal/siding/wood/thin{
	dir = 5
	},
/turf/open/floor/wood/wood_tiled,
/area/hilbertshotel)
"bB" = (
/obj/structure/chair/pew{
	dir = 8
	},
/obj/effect/turf_decal/siding/wood/thin{
	dir = 4
	},
/turf/open/floor/wood/wood_tiled,
/area/hilbertshotel)
"bS" = (
/obj/structure/flora/ausbushes/sparsegrass,
/obj/structure/flora/ausbushes/brflowers,
/obj/structure/flora/biolumi/mine,
/turf/open/floor/grass/grass0,
/area/hilbertshotel)
"cV" = (
/obj/structure/spacevine,
/obj/structure/flora/ausbushes/brflowers,
/turf/closed/indestructible/wood,
/area/hilbertshotel)
"eG" = (
/obj/structure/flora/ausbushes/lavendergrass,
/obj/structure/flora/ausbushes/ywflowers,
/turf/open/floor/grass/grass0,
/area/hilbertshotel)
"fD" = (
/obj/structure/flora/ausbushes/sparsegrass,
/obj/structure/flora/ausbushes/ppflowers,
/obj/structure/flora/ausbushes/ppflowers,
/obj/structure/flora/ausbushes/brflowers,
/turf/open/floor/grass/grass0,
/area/hilbertshotel)
"fP" = (
/obj/structure/flora/ausbushes/sparsegrass,
/obj/structure/flora/ausbushes/ppflowers,
/obj/structure/flora/ausbushes/ywflowers,
/turf/open/floor/grass/grass0,
/area/hilbertshotel)
"gJ" = (
/obj/structure/chair/pew/right{
	dir = 4
	},
/obj/effect/turf_decal/siding/wood/thin{
	dir = 8
	},
/turf/open/floor/wood/wood_tiled,
/area/hilbertshotel)
"gZ" = (
/obj/effect/turf_decal/siding/wood/thin/end,
/turf/open/floor/carpet/royalblue,
/area/hilbertshotel)
"hq" = (
/obj/structure/flora/ausbushes/sparsegrass,
/obj/structure/flora/ausbushes/ywflowers,
/obj/structure/flora/biolumi/lamp,
/turf/open/floor/grass/grass0,
/area/hilbertshotel)
"hy" = (
/obj/structure/flora/ausbushes/sparsegrass,
/obj/structure/flora/ausbushes/brflowers,
/obj/structure/flora/ausbushes/brflowers,
/obj/structure/flora/biolumi,
/turf/open/floor/grass/grass0,
/area/hilbertshotel)
"hO" = (
/obj/structure/flora/ausbushes/sparsegrass,
/obj/structure/flora/biolumi/flower,
/turf/open/floor/grass/grass0,
/area/hilbertshotel)
"iz" = (
/obj/structure/flora/ausbushes/sparsegrass,
/obj/structure/flora/ausbushes/ppflowers,
/obj/structure/flora/ausbushes/brflowers,
/turf/open/floor/grass/grass0,
/area/hilbertshotel)
"jr" = (
/obj/structure/flora/ausbushes/sparsegrass,
/obj/item/lighter/gold,
/obj/structure/flora/ausbushes/brflowers,
/turf/open/floor/grass/grass0,
/area/hilbertshotel)
"jw" = (
/obj/structure/spacevine,
/obj/structure/flora/ausbushes/brflowers,
/obj/structure/flora/ausbushes/ywflowers,
/turf/closed/indestructible/wood,
/area/hilbertshotel)
"jP" = (
/obj/structure/spacevine,
/obj/structure/flora/ausbushes/ywflowers,
/turf/closed/indestructible/wood,
/area/hilbertshotel)
"le" = (
/obj/structure/flora/ausbushes/lavendergrass,
/obj/structure/flora/ausbushes/brflowers,
/obj/structure/flora/ausbushes/brflowers,
/turf/open/floor/grass/grass0,
/area/hilbertshotel)
"lW" = (
/obj/structure/flora/biolumi/flower,
/turf/open/floor/grass/grass3,
/area/hilbertshotel)
"mg" = (
/obj/structure/flora/ausbushes/sparsegrass,
/obj/structure/flora/ausbushes/ywflowers,
/obj/structure/flora/ausbushes/brflowers,
/obj/structure/flora/ausbushes/brflowers,
/turf/open/floor/grass/grass0,
/area/hilbertshotel)
"mr" = (
/obj/structure/flora/rock,
/turf/open/floor/grass/grass3,
/area/hilbertshotel)
"mI" = (
/obj/structure/chair/pew/left{
	dir = 4
	},
/obj/effect/turf_decal/siding/wood/thin{
	dir = 8
	},
/turf/open/floor/wood/wood_tiled,
/area/hilbertshotel)
"nw" = (
/obj/effect/turf_decal/siding/wood/thin/corner{
	dir = 1
	},
/turf/open/floor/wood/wood_tiled,
/area/hilbertshotel)
"oc" = (
/obj/structure/flora/ausbushes/sparsegrass,
/obj/structure/flora/ausbushes/ywflowers,
/turf/open/floor/grass/grass0,
/area/hilbertshotel)
"oB" = (
/obj/effect/turf_decal/siding/wood/thin{
	dir = 9
	},
/turf/open/floor/wood/wood_tiled,
/area/hilbertshotel)
"pU" = (
/obj/structure/flora/tree/spookylog,
/obj/structure/flora/ausbushes/sparsegrass,
/obj/structure/flora/ausbushes/brflowers,
/turf/open/floor/grass/grass0,
/area/hilbertshotel)
"qc" = (
/obj/structure/flora/ausbushes/sparsegrass,
/obj/structure/flora/ausbushes/ywflowers,
/obj/structure/flora/ausbushes/brflowers,
/turf/open/floor/grass/grass0,
/area/hilbertshotel)
"qt" = (
/obj/structure/flora/ausbushes/sparsegrass,
/obj/structure/flora/ausbushes/brflowers,
/obj/structure/flora/ausbushes/brflowers,
/turf/open/floor/grass/grass0,
/area/hilbertshotel)
"rg" = (
/obj/effect/turf_decal/siding/wood/thin{
	dir = 4
	},
/turf/open/floor/wood/wood_tiled,
/area/hilbertshotel)
"rh" = (
/obj/structure/flora/ausbushes/ppflowers,
/obj/structure/flora/ausbushes/ywflowers,
/turf/open/floor/grass/grass0,
/area/hilbertshotel)
"so" = (
/obj/structure/flora/ausbushes/sparsegrass,
/obj/structure/flora/ausbushes/ppflowers,
/obj/structure/flora/ausbushes/ppflowers,
/turf/open/floor/grass/grass0,
/area/hilbertshotel)
"sq" = (
/obj/structure/flora/ausbushes/ywflowers,
/obj/structure/flora/ausbushes/ywflowers,
/obj/structure/flora/ausbushes/brflowers,
/turf/open/floor/grass/grass0,
/area/hilbertshotel)
"st" = (
/obj/item/candle/infinite,
/turf/open/floor/wood/wood_tiled,
/area/hilbertshotel)
"us" = (
/obj/structure/flora/ausbushes/ppflowers,
/obj/structure/flora/ausbushes/ppflowers,
/obj/structure/flora/ausbushes/brflowers,
/obj/structure/flora/ausbushes/brflowers,
/turf/open/floor/grass/grass0,
/area/hilbertshotel)
"vo" = (
/obj/effect/turf_decal/siding/wood/thin,
/turf/open/floor/wood/wood_tiled,
/area/hilbertshotel)
"vR" = (
/obj/structure/flora/ausbushes/sparsegrass,
/obj/machinery/light/floor,
/obj/structure/flora/biolumi/flower,
/turf/open/floor/grass/grass0,
/area/hilbertshotel)
"xr" = (
/obj/structure/flora/ausbushes/sparsegrass,
/obj/structure/flora/ausbushes/ppflowers,
/obj/structure/flora/ausbushes/brflowers,
/obj/structure/flora/biolumi/lamp,
/turf/open/floor/grass/grass0,
/area/hilbertshotel)
"ym" = (
/obj/structure/chair/pew/left{
	dir = 8
	},
/obj/effect/turf_decal/siding/wood/thin{
	dir = 4
	},
/turf/open/floor/wood/wood_tiled,
/area/hilbertshotel)
"yI" = (
/obj/structure/flora/ausbushes/sparsegrass,
/obj/machinery/light/floor,
/turf/open/floor/grass/grass0,
/area/hilbertshotel)
"yM" = (
/obj/structure/flora/ausbushes/lavendergrass,
/obj/structure/flora/ausbushes/ywflowers,
/obj/structure/flora/ausbushes/brflowers,
/turf/open/floor/grass/grass0,
/area/hilbertshotel)
"zn" = (
/obj/machinery/telecomms/relay/preset/auto,
/turf/open/floor/catwalk_floor,
/area/hilbertshotel)
"An" = (
/obj/structure/flora/ausbushes/sparsegrass,
/obj/structure/flora/ausbushes/brflowers,
/obj/structure/flora/ausbushes/brflowers,
/obj/structure/flora/ausbushes/brflowers,
/turf/open/floor/grass/grass0,
/area/hilbertshotel)
"At" = (
/obj/structure/flora/ausbushes/ywflowers,
/obj/structure/flora/ausbushes/ywflowers,
/obj/structure/flora/ausbushes/brflowers,
/obj/structure/flora/biolumi/lamp,
/turf/open/floor/grass/grass0,
/area/hilbertshotel)
"Bb" = (
/obj/structure/spacevine,
/obj/structure/flora/ausbushes/brflowers,
/obj/structure/flora/ausbushes/ppflowers,
/turf/closed/indestructible/wood,
/area/hilbertshotel)
"Bw" = (
/obj/structure/flora/ausbushes/sparsegrass,
/turf/open/floor/grass/grass3,
/area/hilbertshotel)
"BR" = (
/turf/closed/indestructible/hoteldoor{
	icon_state = "door_closed";
	icon = 'icons/obj/doors/puzzledoor/default.dmi'
	},
/area/hilbertshotel)
"BZ" = (
/obj/structure/flora/ausbushes/sparsegrass,
/obj/structure/flora/ausbushes/brflowers,
/turf/open/floor/grass/grass0,
/area/hilbertshotel)
"CK" = (
/obj/structure/flora/tree/jungle{
	pixel_x = -31;
	pixel_y = 0
	},
/obj/structure/flora/ausbushes/sparsegrass,
/turf/open/floor/grass/grass3,
/area/hilbertshotel)
"CP" = (
/obj/structure/flora/ausbushes/sparsegrass,
/obj/structure/flora/ausbushes/ppflowers,
/obj/structure/flora/ausbushes/brflowers,
/obj/structure/flora/ausbushes/brflowers,
/turf/open/floor/grass/grass0,
/area/hilbertshotel)
"CU" = (
/obj/structure/chair/pew/left{
	dir = 1
	},
/obj/effect/turf_decal/siding/wood/thin,
/turf/open/floor/wood/wood_tiled,
/area/hilbertshotel)
"Dj" = (
/obj/structure/flora/ausbushes/sparsegrass,
/obj/structure/flora/ausbushes/brflowers,
/obj/structure/flora/rock,
/turf/open/floor/grass/grass0,
/area/hilbertshotel)
"Ds" = (
/obj/structure/flora/ausbushes/brflowers,
/obj/structure/flora/rock,
/turf/open/floor/grass/grass0,
/area/hilbertshotel)
"Dw" = (
/obj/structure/chair/pew/right,
/obj/effect/turf_decal/siding/wood/thin{
	dir = 1
	},
/turf/open/floor/wood/wood_tiled,
/area/hilbertshotel)
"DL" = (
/obj/structure/flora/ausbushes/brflowers,
/turf/closed/indestructible/wood,
/area/hilbertshotel)
"DP" = (
/obj/structure/flora/ausbushes/sparsegrass,
/obj/structure/flora/ausbushes/brflowers,
/obj/structure/flora/biolumi/flower,
/turf/open/floor/grass/grass0,
/area/hilbertshotel)
"Er" = (
/obj/structure/flora/ausbushes/sparsegrass,
/turf/open/floor/grass/grass0,
/area/hilbertshotel)
"Ev" = (
/obj/structure/flora/ausbushes/sparsegrass,
/obj/structure/flora/ausbushes/ppflowers,
/obj/structure/flora/ausbushes/brflowers,
/obj/structure/flora/ausbushes/brflowers,
/obj/structure/flora/biolumi/flower,
/turf/open/floor/grass/grass0,
/area/hilbertshotel)
"Ex" = (
/obj/structure/chair/pew/right{
	dir = 1
	},
/obj/effect/turf_decal/siding/wood/thin,
/turf/open/floor/wood/wood_tiled,
/area/hilbertshotel)
"Fm" = (
/obj/structure/flora/ausbushes/ywflowers,
/obj/structure/flora/ausbushes/brflowers,
/obj/structure/flora/rock,
/turf/open/floor/grass/grass0,
/area/hilbertshotel)
"FZ" = (
/obj/structure/flora/ausbushes/sparsegrass,
/obj/machinery/light/floor,
/obj/structure/flora/ausbushes/brflowers,
/obj/structure/flora/ausbushes/brflowers,
/turf/open/floor/grass/grass0,
/area/hilbertshotel)
"HM" = (
/obj/machinery/light/floor,
/obj/structure/flora/ausbushes/brflowers,
/turf/open/floor/grass/grass0,
/area/hilbertshotel)
"Ib" = (
/obj/structure/chair/pew/right{
	dir = 8
	},
/obj/effect/turf_decal/siding/wood/thin{
	dir = 4
	},
/turf/open/floor/wood/wood_tiled,
/area/hilbertshotel)
"Ig" = (
/obj/effect/turf_decal/siding/wood/thin{
	dir = 6
	},
/turf/open/floor/wood/wood_tiled,
/area/hilbertshotel)
"Iw" = (
/obj/structure/flora/ausbushes/ywflowers,
/obj/structure/flora/ausbushes/brflowers,
/turf/open/floor/grass/grass0,
/area/hilbertshotel)
"IS" = (
/obj/effect/turf_decal/siding/wood/thin/corner{
	dir = 4
	},
/turf/open/floor/wood/wood_tiled,
/area/hilbertshotel)
"Ku" = (
/obj/structure/flora/tree/spookylog,
/obj/structure/flora/ausbushes/sparsegrass,
/obj/structure/flora/ausbushes/ppflowers,
/obj/structure/flora/ausbushes/brflowers,
/turf/open/floor/grass/grass0,
/area/hilbertshotel)
"KI" = (
/obj/structure/chair/pew{
	dir = 4
	},
/obj/effect/turf_decal/siding/wood/thin{
	dir = 8
	},
/turf/open/floor/wood/wood_tiled,
/area/hilbertshotel)
"KJ" = (
/obj/effect/turf_decal/siding/wood/thin/end{
	dir = 1
	},
/turf/open/floor/carpet/royalblue,
/area/hilbertshotel)
"Mn" = (
/obj/effect/turf_decal/siding/wood/thin{
	dir = 8
	},
/turf/open/floor/wood/wood_tiled,
/area/hilbertshotel)
"MP" = (
/obj/effect/turf_decal/siding/wood/thin/corner{
	dir = 8
	},
/turf/open/floor/wood/wood_tiled,
/area/hilbertshotel)
"Nm" = (
/obj/effect/turf_decal/siding/wood/thin/corner,
/turf/open/floor/wood/wood_tiled,
/area/hilbertshotel)
"NS" = (
/obj/structure/flora/ausbushes/ywflowers,
/obj/structure/flora/ausbushes/ppflowers,
/obj/structure/flora/ausbushes/brflowers,
/obj/structure/flora/ausbushes/brflowers,
/turf/open/floor/grass/grass0,
/area/hilbertshotel)
"Ov" = (
/obj/effect/turf_decal/siding/wood/thin{
	dir = 10
	},
/turf/open/floor/wood/wood_tiled,
/area/hilbertshotel)
"OC" = (
/obj/structure/flora/biolumi/mine,
/turf/open/floor/grass/grass3,
/area/hilbertshotel)
"OS" = (
/obj/structure/spacevine,
/obj/structure/flora/ausbushes/brflowers,
/obj/structure/flora/ausbushes/ywflowers,
/obj/structure/flora/ausbushes/ppflowers,
/turf/closed/indestructible/wood,
/area/hilbertshotel)
"OV" = (
/obj/structure/flora/ausbushes/sparsegrass,
/obj/structure/flora/ausbushes/ppflowers,
/obj/structure/flora/ausbushes/ppflowers,
/obj/structure/flora/ausbushes/ywflowers,
/turf/open/floor/grass/grass0,
/area/hilbertshotel)
"QY" = (
/obj/structure/chair/pew{
	dir = 1
	},
/obj/effect/turf_decal/siding/wood/thin,
/turf/open/floor/wood/wood_tiled,
/area/hilbertshotel)
"RJ" = (
/obj/structure/flora/ausbushes/ywflowers,
/turf/closed/indestructible/wood,
/area/hilbertshotel)
"Sb" = (
/obj/structure/spacevine,
/obj/structure/flora/ausbushes/ywflowers,
/obj/structure/flora/ausbushes/ppflowers,
/turf/closed/indestructible/wood,
/area/hilbertshotel)
"Td" = (
/obj/structure/flora/ausbushes/ppflowers,
/turf/closed/indestructible/wood,
/area/hilbertshotel)
"Tf" = (
/obj/structure/flora/tree/spookylog,
/obj/structure/flora/ausbushes/sparsegrass,
/obj/structure/flora/ausbushes/brflowers,
/obj/structure/flora/ausbushes/brflowers,
/turf/open/floor/grass/grass0,
/area/hilbertshotel)
"Tk" = (
/obj/structure/flora/ausbushes/sparsegrass,
/obj/structure/flora/ausbushes/ywflowers,
/obj/structure/flora/ausbushes/brflowers,
/obj/structure/flora/ausbushes/brflowers,
/obj/structure/flora/biolumi/flower,
/turf/open/floor/grass/grass0,
/area/hilbertshotel)
"TG" = (
/turf/open/space/bluespace,
/area/hilbertshotel)
"TK" = (
/obj/structure/flora/ausbushes/ywflowers,
/turf/open/floor/grass/grass0,
/area/hilbertshotel)
"Uc" = (
/obj/structure/chair/pew,
/obj/effect/turf_decal/siding/wood/thin{
	dir = 1
	},
/turf/open/floor/wood/wood_tiled,
/area/hilbertshotel)
"UT" = (
/obj/structure/flora/ausbushes/sparsegrass,
/obj/structure/flora/ausbushes/brflowers,
/obj/structure/flora/biolumi,
/turf/open/floor/grass/grass0,
/area/hilbertshotel)
"Vw" = (
/obj/effect/turf_decal/siding/wood/thin/end{
	dir = 8
	},
/turf/open/floor/carpet/royalblue,
/area/hilbertshotel)
"WU" = (
/obj/structure/flora/ausbushes/ywflowers,
/obj/structure/flora/ausbushes/ppflowers,
/obj/structure/flora/ausbushes/brflowers,
/turf/open/floor/grass/grass0,
/area/hilbertshotel)
"XC" = (
/obj/structure/flora/ausbushes/sparsegrass,
/obj/structure/flora/ausbushes/brflowers,
/obj/structure/flora/biolumi/lamp,
/turf/open/floor/grass/grass0,
/area/hilbertshotel)
"Yx" = (
/obj/effect/turf_decal/siding/wood/thin/end{
	dir = 4
	},
/turf/open/floor/carpet/royalblue,
/area/hilbertshotel)
"Yy" = (
/obj/structure/flora/ausbushes/ppflowers,
/obj/structure/flora/ausbushes/brflowers,
/obj/structure/flora/ausbushes/brflowers,
/turf/open/floor/grass/grass0,
/area/hilbertshotel)
"YJ" = (
/obj/structure/chair/pew/left,
/obj/effect/turf_decal/siding/wood/thin{
	dir = 1
	},
/turf/open/floor/wood/wood_tiled,
/area/hilbertshotel)
"YO" = (
/obj/effect/turf_decal/siding/wood/thin{
	dir = 1
	},
/turf/open/floor/wood/wood_tiled,
/area/hilbertshotel)
"Zi" = (
/obj/structure/flora/ausbushes/lavendergrass,
/obj/structure/flora/ausbushes/ppflowers,
/obj/structure/flora/ausbushes/ywflowers,
/obj/structure/flora/ausbushes/brflowers,
/turf/open/floor/grass/grass0,
/area/hilbertshotel)
"Zj" = (
/obj/structure/flora/ausbushes/sparsegrass,
/obj/machinery/light/floor,
/obj/structure/flora/ausbushes/brflowers,
/turf/open/floor/grass/grass0,
/area/hilbertshotel)
"ZK" = (
/obj/structure/flora/ausbushes/sparsegrass,
/obj/structure/flora/ausbushes/ppflowers,
/turf/open/floor/grass/grass0,
/area/hilbertshotel)
"ZP" = (
/obj/structure/spacevine,
/obj/structure/flora/ausbushes/ppflowers,
/turf/closed/indestructible/wood,
/area/hilbertshotel)
"ZZ" = (
/obj/structure/flora/ausbushes/ppflowers,
/obj/structure/flora/ausbushes/brflowers,
/obj/structure/flora/ausbushes/brflowers,
/obj/structure/flora/biolumi,
/obj/structure/flora/biolumi/mine,
/turf/open/floor/grass/grass0,
/area/hilbertshotel)

(1,1,1) = {"
TG
TG
TG
TG
TG
TG
TG
TG
TG
TG
TG
TG
TG
TG
TG
TG
TG
TG
"}
(2,1,1) = {"
TG
TG
TG
RJ
ZP
OS
BR
cV
Sb
cV
jP
Sb
jP
cV
DL
TG
TG
TG
"}
(3,1,1) = {"
TG
TG
Td
Bb
BZ
qc
yM
jr
At
mg
qt
le
mg
UT
jP
Td
TG
TG
"}
(4,1,1) = {"
TG
DL
jP
DP
oc
rh
oc
oc
fP
Er
us
Tf
mg
eG
BZ
Sb
RJ
TG
"}
(5,1,1) = {"
TG
Sb
Yy
Fm
oc
Zj
oB
gJ
KI
KI
mI
Ov
vR
oc
sq
hO
jP
TG
"}
(6,1,1) = {"
TG
jP
bS
fP
yI
oB
nw
st
KJ
gZ
st
MP
Ov
yI
oc
BZ
jP
TG
"}
(7,1,1) = {"
TG
ZP
iz
OV
oB
nw
Nm
rg
rg
rg
rg
IS
MP
Ov
rh
BZ
OS
TG
"}
(8,1,1) = {"
TG
Bb
xr
so
YJ
st
vo
Bw
lW
Bw
mr
YO
st
CU
Zi
iz
jw
TG
"}
(9,1,1) = {"
TG
jP
fD
NS
Uc
Vw
vo
Bw
Bw
CK
Bw
YO
Vw
QY
fP
BZ
Sb
TG
"}
(10,1,1) = {"
TG
jw
ZK
BZ
Uc
Yx
vo
Bw
Bw
Bw
lW
YO
Yx
QY
ZK
ZZ
cV
TG
"}
(11,1,1) = {"
TG
jP
Ku
XC
Dw
st
vo
lW
Bw
OC
Bw
YO
st
Ex
ZK
UT
ZP
TG
"}
(12,1,1) = {"
TG
jP
us
BZ
aq
IS
MP
Mn
Mn
Mn
Mn
nw
Nm
Ig
ZK
TK
jw
TG
"}
(13,1,1) = {"
TG
OS
iz
Ev
Zj
aq
IS
st
KJ
gZ
st
Nm
Ig
vR
CP
BZ
ZP
TG
"}
(14,1,1) = {"
TG
Sb
BZ
WU
An
HM
aq
ym
bB
bB
Ib
Ig
FZ
CP
Ds
DP
jP
TG
"}
(15,1,1) = {"
TG
RJ
ZP
bS
BZ
qt
Dj
yM
oc
hq
qc
BZ
iz
us
qt
ZP
Td
TG
"}
(16,1,1) = {"
TG
TG
Td
jP
UT
eG
oc
Tk
BZ
Iw
qt
pU
hy
qt
ZP
RJ
zn
TG
"}
(17,1,1) = {"
TG
TG
TG
DL
ZP
Bb
Sb
Bb
Sb
jP
OS
jP
Sb
OS
Td
TG
TG
TG
"}
(18,1,1) = {"
TG
TG
TG
TG
TG
TG
TG
TG
TG
TG
TG
TG
TG
TG
TG
TG
TG
TG
"}
