//MAP CONVERTED BY dmm2tgm.py THIS HEADER COMMENT PREVENTS RECONVERSION, DO NOT REMOVE
"aN" = (
/obj/structure/dresser,
/obj/machinery/light_switch/directional/east,
/turf/open/floor/carpet/red,
/area/hilbertshotel)
"bd" = (
/obj/machinery/vending/cigarette{
	shut_up = 1
	},
/turf/open/floor/plasteel/cafeteria,
/area/hilbertshotel)
"dm" = (
/obj/structure/closet/secure_closet/personal,
/obj/structure/window/reinforced/tinted/frosted{
	dir = 4
	},
/obj/structure/window/reinforced/tinted/frosted{
	dir = 8
	},
/turf/open/floor/wood/wood_large,
/area/hilbertshotel)
"ed" = (
/obj/structure/closet/crate/wooden,
/obj/item/stack/sheet/mineral/wood/fifty,
/obj/item/lighter/gold,
/obj/effect/turf_decal/siding/wood/thin{
	dir = 8
	},
/turf/open/floor/carpet/red,
/area/hilbertshotel)
"fb" = (
/obj/item/kirbyplants/random,
/obj/effect/turf_decal/siding/wood/thin{
	dir = 9
	},
/turf/open/floor/carpet/royalblue,
/area/hilbertshotel)
"fo" = (
/obj/machinery/light_switch/directional/east,
/obj/effect/turf_decal/siding/wood/thin{
	dir = 4
	},
/turf/open/floor/carpet/royalblue,
/area/hilbertshotel)
"fy" = (
/obj/effect/turf_decal/siding/wood/thin/corner{
	dir = 8
	},
/turf/open/floor/carpet/royalblue,
/area/hilbertshotel)
"fG" = (
/obj/machinery/light{
	dir = 1
	},
/turf/open/floor/plasteel/white/textured,
/area/hilbertshotel)
"fH" = (
/obj/machinery/light,
/obj/structure/chair/stool/bar/directional/east,
/turf/open/floor/plasteel/cafeteria,
/area/hilbertshotel)
"fW" = (
/obj/structure/bed,
/turf/open/floor/plasteel/white,
/area/hilbertshotel)
"gP" = (
/obj/structure/table/glass,
/obj/structure/bedsheetbin/towel,
/turf/open/floor/plasteel/white/textured,
/area/hilbertshotel)
"gS" = (
/obj/machinery/door/morgue,
/turf/open/floor/plasteel/dark/textured,
/area/hilbertshotel)
"gV" = (
/obj/structure/rack,
/obj/effect/turf_decal/siding/wood/thin{
	dir = 10
	},
/turf/open/floor/carpet/royalblue,
/area/hilbertshotel)
"hw" = (
/obj/structure/sauna_oven,
/turf/open/floor/wood/wood_tiled,
/area/hilbertshotel)
"hJ" = (
/turf/open/floor/wood,
/area/hilbertshotel)
"ix" = (
/obj/effect/turf_decal/siding/wood/thin{
	dir = 1
	},
/turf/open/floor/carpet/royalblue,
/area/hilbertshotel)
"iJ" = (
/obj/structure/closet/athletic_mixed,
/obj/structure/window/reinforced/tinted/frosted{
	dir = 4
	},
/obj/structure/window/reinforced/tinted/frosted{
	dir = 8
	},
/turf/open/floor/wood/wood_large,
/area/hilbertshotel)
"jr" = (
/obj/structure/sign/poster/contraband/random{
	pixel_x = -31
	},
/turf/open/floor/wood,
/area/hilbertshotel)
"jP" = (
/obj/machinery/vending/dinnerware{
	contraband = list(/obj/item/kitchen/rollingpin=2,/obj/item/kitchen/knife/butcher=2,/obj/item/reagent_containers/food/condiment/flour=4);
	shut_up = 1
	},
/turf/open/floor/plasteel/cafeteria,
/area/hilbertshotel)
"jX" = (
/obj/structure/mineral_door/paperframe{
	name = "Changing Room";
	dir = 4
	},
/turf/open/floor/plasteel/white/textured,
/area/hilbertshotel)
"kd" = (
/obj/structure/pool/Rboard,
/turf/open/floor/plasteel/white,
/area/hilbertshotel)
"ly" = (
/obj/structure/closet/crate/bin{
	pixel_x = -7;
	pixel_y = 0
	},
/turf/open/floor/plasteel/cafeteria,
/area/hilbertshotel)
"mc" = (
/obj/machinery/pool/controller,
/obj/structure/railing{
	dir = 8
	},
/obj/machinery/light{
	dir = 4;
	light_color = "#c1caff"
	},
/turf/open/floor/plasteel/white,
/area/hilbertshotel)
"ne" = (
/obj/machinery/light_switch/directional/north,
/obj/effect/turf_decal/siding/wood/thin{
	dir = 1
	},
/turf/open/floor/carpet/royalblue,
/area/hilbertshotel)
"nJ" = (
/obj/effect/turf_decal/siding/wood/thin{
	dir = 1
	},
/turf/open/floor/wood/wood_tiled,
/area/hilbertshotel)
"oz" = (
/obj/structure/railing{
	dir = 8
	},
/obj/machinery/pool/filter{
	pixel_y = -17
	},
/obj/structure/railing,
/turf/open/floor/plasteel/white,
/area/hilbertshotel)
"oR" = (
/obj/structure/closet/athletic_mixed,
/obj/structure/window/reinforced/tinted/frosted{
	dir = 4
	},
/turf/open/floor/wood/wood_large,
/area/hilbertshotel)
"pw" = (
/obj/structure/mineral_door/paperframe{
	name = "Changing Room";
	dir = 8
	},
/turf/open/floor/wood,
/area/hilbertshotel)
"pE" = (
/obj/machinery/light{
	dir = 8;
	light_color = "#e8eaff"
	},
/obj/effect/turf_decal/siding/wood/thin{
	dir = 8
	},
/turf/open/floor/carpet/royalblue,
/area/hilbertshotel)
"pJ" = (
/obj/machinery/light,
/obj/effect/turf_decal/siding/wood/thin,
/turf/open/floor/carpet/royalblue,
/area/hilbertshotel)
"qi" = (
/obj/machinery/light/floor,
/turf/open/floor/wood/wood_tiled,
/area/hilbertshotel)
"qm" = (
/obj/structure/table/wood,
/obj/item/wrench,
/turf/open/floor/wood,
/area/hilbertshotel)
"qv" = (
/obj/structure/chair/pew/right{
	dir = 8
	},
/turf/open/floor/wood/wood_tiled,
/area/hilbertshotel)
"qR" = (
/obj/structure/closet/crate/wooden,
/obj/item/clothing/shoes/sandal,
/obj/item/clothing/shoes/sandal,
/obj/item/clothing/shoes/sandal,
/obj/item/clothing/shoes/sandal,
/obj/item/clothing/shoes/sandal,
/obj/item/clothing/shoes/sandal,
/obj/item/clothing/shoes/sandal,
/obj/item/clothing/shoes/sandal,
/obj/item/clothing/shoes/sandal,
/obj/item/clothing/shoes/sandal,
/obj/item/clothing/shoes/sandal,
/obj/item/clothing/shoes/sandal,
/obj/item/clothing/shoes/sandal,
/obj/effect/turf_decal/siding/wood/thin,
/turf/open/floor/carpet/royalblue,
/area/hilbertshotel)
"rb" = (
/obj/machinery/light{
	dir = 4
	},
/obj/effect/turf_decal/siding/wood/thin{
	dir = 6
	},
/obj/machinery/vending/games{
	shut_up = 1
	},
/turf/open/floor/carpet/royalblue,
/area/hilbertshotel)
"rX" = (
/obj/structure/mineral_door/paperframe{
	name = "Changing Room";
	dir = 8
	},
/turf/open/floor/plasteel/white,
/area/hilbertshotel)
"tB" = (
/obj/machinery/light,
/turf/open/floor/wood,
/area/hilbertshotel)
"tF" = (
/obj/structure/chair/stool/bar/directional/east,
/turf/open/floor/plasteel/cafeteria,
/area/hilbertshotel)
"tS" = (
/turf/open/space/bluespace,
/area/hilbertshotel)
"tX" = (
/obj/structure/table,
/obj/effect/spawner/lootdrop/three_course_meal,
/turf/open/floor/plasteel/cafeteria,
/area/hilbertshotel)
"ut" = (
/obj/effect/turf_decal/siding/wood/thin/corner{
	dir = 8
	},
/obj/effect/turf_decal/siding/wood/thin/corner{
	dir = 1
	},
/turf/open/floor/carpet/royalblue,
/area/hilbertshotel)
"uG" = (
/obj/structure/sign/painting/library{
	pixel_x = -32
	},
/obj/effect/turf_decal/siding/wood/thin{
	dir = 8
	},
/obj/effect/turf_decal/siding/wood/thin/corner,
/turf/open/floor/carpet/royalblue,
/area/hilbertshotel)
"vL" = (
/obj/effect/turf_decal/siding/wood/thin,
/turf/open/floor/carpet/royalblue,
/area/hilbertshotel)
"vN" = (
/obj/effect/turf_decal/siding/wood/thin/corner{
	dir = 4
	},
/obj/effect/turf_decal/siding/wood/thin/corner,
/turf/open/floor/carpet/royalblue,
/area/hilbertshotel)
"vT" = (
/turf/open/floor/catwalk_floor,
/area/hilbertshotel)
"wy" = (
/obj/machinery/light_switch/directional/west,
/obj/effect/turf_decal/siding/wood/thin{
	dir = 8
	},
/turf/open/floor/carpet/royalblue,
/area/hilbertshotel)
"wD" = (
/obj/structure/table/wood,
/obj/item/pizzabox/margherita{
	pixel_y = 11
	},
/turf/open/floor/wood,
/area/hilbertshotel)
"xp" = (
/obj/structure/table/wood,
/turf/open/floor/plasteel/dark/textured,
/area/hilbertshotel)
"xD" = (
/obj/effect/turf_decal/siding/wood/thin{
	dir = 1
	},
/obj/effect/turf_decal/siding/wood/thin/corner{
	dir = 8
	},
/turf/open/floor/carpet/royalblue,
/area/hilbertshotel)
"xU" = (
/obj/structure/reagent_dispensers/keg/aphro/strong,
/obj/machinery/light{
	dir = 4
	},
/obj/structure/table/wood,
/turf/open/floor/plasteel/dark/textured,
/area/hilbertshotel)
"zw" = (
/obj/effect/turf_decal/siding/wood/thin{
	dir = 4
	},
/turf/open/floor/carpet/royalblue,
/area/hilbertshotel)
"zJ" = (
/turf/open/floor/plasteel/white/textured,
/area/hilbertshotel)
"Aq" = (
/obj/structure/chair/pew/left{
	dir = 4
	},
/turf/open/floor/wood/wood_tiled,
/area/hilbertshotel)
"Au" = (
/obj/structure/table,
/obj/machinery/vending/boozeomat{
	onstation = 0;
	shut_up = 1;
	pixel_x = 32;
	pixel_y = 0;
	density = 0
	},
/turf/open/floor/plasteel/cafeteria,
/area/hilbertshotel)
"BQ" = (
/obj/machinery/vending/kink{
	onstation = 0;
	shut_up = 1
	},
/turf/open/floor/plasteel/dark/textured,
/area/hilbertshotel)
"CG" = (
/obj/effect/turf_decal/siding/wood/thin/corner{
	dir = 1
	},
/turf/open/floor/carpet/royalblue,
/area/hilbertshotel)
"CU" = (
/obj/structure/closet/cabinet,
/turf/open/floor/wood,
/area/hilbertshotel)
"CY" = (
/obj/machinery/light_switch/directional/east,
/turf/open/floor/wood,
/area/hilbertshotel)
"CZ" = (
/obj/structure/reagent_dispensers/watertank,
/obj/structure/window/reinforced/tinted/frosted,
/turf/open/floor/plasteel/white/textured,
/area/hilbertshotel)
"Dt" = (
/obj/structure/chair/pew{
	dir = 4
	},
/turf/open/floor/wood/wood_tiled,
/area/hilbertshotel)
"DO" = (
/obj/structure/table,
/obj/machinery/light{
	dir = 4;
	light_color = "#c1caff"
	},
/turf/open/floor/plasteel/white,
/area/hilbertshotel)
"EF" = (
/turf/open/floor/plasteel/white,
/area/hilbertshotel)
"EW" = (
/obj/effect/turf_decal/misc/drain,
/obj/machinery/door/window/southright,
/turf/open/floor/plasteel/white/textured,
/area/hilbertshotel)
"Gf" = (
/obj/machinery/pool/drain,
/turf/open/pool,
/area/hilbertshotel)
"Gm" = (
/obj/structure/pool/ladder{
	dir = 8;
	pixel_x = 4
	},
/turf/open/pool,
/area/hilbertshotel)
"Gs" = (
/obj/structure/sign/flag/nanotrasen{
	pixel_y = 29;
	pixel_x = 1
	},
/obj/effect/turf_decal/siding/wood/thin{
	dir = 1
	},
/turf/open/floor/carpet/royalblue,
/area/hilbertshotel)
"Gw" = (
/obj/structure/fireplace{
	pixel_x = 0
	},
/obj/effect/turf_decal/siding/wood/thin{
	dir = 8
	},
/turf/open/floor/carpet/red,
/area/hilbertshotel)
"GJ" = (
/turf/closed/indestructible/hoteldoor{
	icon_state = "door_closed";
	icon = 'icons/obj/doors/puzzledoor/default.dmi'
	},
/area/hilbertshotel)
"HN" = (
/obj/structure/table/glass,
/obj/machinery/light{
	dir = 4;
	light_color = "#c1caff"
	},
/turf/open/floor/plasteel/white,
/area/hilbertshotel)
"Kq" = (
/obj/structure/chair/pew/left{
	dir = 8
	},
/obj/effect/turf_decal/siding/wood/thin{
	dir = 1
	},
/turf/open/floor/wood/wood_tiled,
/area/hilbertshotel)
"Kt" = (
/obj/structure/pool/Lboard,
/turf/open/pool,
/area/hilbertshotel)
"Kz" = (
/obj/structure/rack,
/obj/item/pool/pool_noodle/blue,
/obj/item/pool/pool_noodle/blue,
/obj/item/pool/pool_noodle/blue,
/turf/open/floor/wood,
/area/hilbertshotel)
"KG" = (
/turf/open/floor/wood/wood_tiled,
/area/hilbertshotel)
"KL" = (
/obj/effect/turf_decal/siding/wood/thin{
	dir = 8
	},
/turf/open/floor/carpet/red,
/area/hilbertshotel)
"LP" = (
/obj/structure/sign/flag/syndicate{
	pixel_y = 29;
	pixel_x = -1
	},
/obj/effect/turf_decal/siding/wood/thin{
	dir = 1
	},
/turf/open/floor/carpet/royalblue,
/area/hilbertshotel)
"LU" = (
/obj/structure/chair/pew/right{
	dir = 4
	},
/obj/effect/turf_decal/siding/wood/thin{
	dir = 1
	},
/turf/open/floor/wood/wood_tiled,
/area/hilbertshotel)
"Ml" = (
/obj/structure/sign/poster/contraband/random{
	pixel_x = 29
	},
/obj/structure/bed/double,
/obj/item/bedsheet/random/double,
/turf/open/floor/carpet/red,
/area/hilbertshotel)
"MT" = (
/obj/machinery/jukebox{
	req_one_access = null
	},
/turf/open/floor/carpet/red,
/area/hilbertshotel)
"NC" = (
/obj/structure/table/wood,
/obj/item/flashlight/lamp/green{
	pixel_x = 5;
	pixel_y = 3
	},
/turf/open/floor/carpet/red,
/area/hilbertshotel)
"ND" = (
/obj/structure/sign/painting/library{
	pixel_y = -32
	},
/obj/effect/turf_decal/siding/wood/thin,
/turf/open/floor/carpet/royalblue,
/area/hilbertshotel)
"Op" = (
/obj/structure/mineral_door/paperframe{
	name = "Changing Room";
	dir = 8
	},
/turf/open/floor/plasteel/cafeteria,
/area/hilbertshotel)
"OE" = (
/turf/closed/indestructible/wood,
/area/hilbertshotel)
"OQ" = (
/obj/structure/closet/crate/bin{
	pixel_x = -2
	},
/obj/effect/turf_decal/siding/wood/thin{
	dir = 5
	},
/turf/open/floor/carpet/royalblue,
/area/hilbertshotel)
"OW" = (
/obj/effect/turf_decal/siding/wood/thin/corner{
	dir = 1
	},
/obj/effect/turf_decal/siding/wood/thin/corner{
	dir = 8
	},
/turf/open/floor/carpet/royalblue,
/area/hilbertshotel)
"OY" = (
/turf/open/pool,
/area/hilbertshotel)
"Ph" = (
/obj/structure/table,
/turf/open/floor/plasteel/cafeteria,
/area/hilbertshotel)
"Pn" = (
/turf/open/floor/plasteel/dark/textured,
/area/hilbertshotel)
"PD" = (
/turf/open/floor/carpet/red,
/area/hilbertshotel)
"QM" = (
/obj/effect/turf_decal/siding/wood/thin{
	dir = 8
	},
/turf/open/floor/carpet/royalblue,
/area/hilbertshotel)
"QS" = (
/obj/structure/railing{
	dir = 8
	},
/obj/structure/table,
/obj/structure/bedsheetbin/towel,
/turf/open/floor/plasteel/white,
/area/hilbertshotel)
"Rt" = (
/obj/structure/bookcase/random,
/turf/open/floor/wood,
/area/hilbertshotel)
"Rz" = (
/obj/machinery/shower{
	desc = "Despite their age, they seem clean and capable of providing hot water just as well as their modern counterparts. Hopefully Nanotrasen cleaned the water pipes this well...";
	dir = 4
	},
/turf/open/pool,
/area/hilbertshotel)
"RY" = (
/obj/structure/railing{
	dir = 8
	},
/turf/open/floor/plasteel/white,
/area/hilbertshotel)
"Si" = (
/obj/machinery/telecomms/relay/preset/auto,
/turf/open/floor/catwalk_floor,
/area/hilbertshotel)
"Sv" = (
/obj/machinery/light{
	dir = 8;
	light_color = "#e8eaff"
	},
/turf/open/pool,
/area/hilbertshotel)
"Tn" = (
/obj/structure/table/bronze,
/turf/open/floor/wood/wood_tiled,
/area/hilbertshotel)
"Tp" = (
/obj/structure/window/reinforced/tinted/frosted,
/turf/open/floor/plasteel/white/textured,
/area/hilbertshotel)
"TH" = (
/obj/structure/mineral_door/paperframe{
	name = "Changing Room";
	dir = 4
	},
/turf/open/floor/wood,
/area/hilbertshotel)
"Ur" = (
/obj/machinery/shower{
	pixel_y = 16
	},
/obj/effect/turf_decal/misc/drain,
/turf/open/floor/plasteel/white/textured,
/area/hilbertshotel)
"UJ" = (
/obj/item/stack/sheet/mineral/wood/fifty,
/obj/item/stack/sheet/mineral/wood/fifty,
/obj/item/reagent_containers/glass/bucket{
	pixel_y = 7
	},
/obj/structure/closet/crate/wooden,
/turf/open/floor/plasteel/white/textured,
/area/hilbertshotel)
"UR" = (
/obj/effect/turf_decal/siding/wood/thin/corner,
/obj/effect/turf_decal/siding/wood/thin/corner{
	dir = 4
	},
/turf/open/floor/carpet/royalblue,
/area/hilbertshotel)
"Wj" = (
/obj/structure/chair/pew{
	dir = 8
	},
/turf/open/floor/wood/wood_tiled,
/area/hilbertshotel)
"WQ" = (
/obj/structure/sign/painting/library{
	pixel_x = 32
	},
/obj/effect/turf_decal/siding/wood/thin{
	dir = 4
	},
/turf/open/floor/carpet/royalblue,
/area/hilbertshotel)
"XH" = (
/turf/open/floor/plasteel/cafeteria,
/area/hilbertshotel)
"Ym" = (
/obj/structure/closet/secure_closet/personal,
/obj/structure/window/reinforced/tinted/frosted{
	dir = 8
	},
/turf/open/floor/wood/wood_large,
/area/hilbertshotel)
"Zm" = (
/obj/machinery/light{
	dir = 4
	},
/obj/effect/turf_decal/siding/wood/thin{
	dir = 4
	},
/turf/open/floor/carpet/royalblue,
/area/hilbertshotel)

(1,1,1) = {"
tS
tS
tS
tS
tS
tS
tS
tS
tS
tS
tS
tS
tS
tS
tS
tS
tS
tS
"}
(2,1,1) = {"
tS
OE
OE
OE
OE
OE
GJ
OE
OE
OE
OE
OE
OE
OE
OE
OE
OE
tS
"}
(3,1,1) = {"
tS
OE
oR
jr
Kz
OE
xD
gV
OE
OY
Sv
Rz
OY
Rz
Sv
OY
OE
tS
"}
(4,1,1) = {"
tS
OE
iJ
hJ
hJ
OE
ne
qR
OE
OY
OY
OY
Gf
OY
OY
OY
OE
tS
"}
(5,1,1) = {"
tS
OE
dm
hJ
tB
OE
Gs
pJ
OE
OY
Kt
Gm
OY
OY
OY
OY
OE
tS
"}
(6,1,1) = {"
tS
OE
dm
hJ
hJ
OE
LP
vL
OE
QS
kd
EF
RY
RY
oz
OY
OE
tS
"}
(7,1,1) = {"
tS
OE
Ym
hJ
CY
OE
ix
vL
OE
DO
EF
fW
HN
fW
EF
mc
OE
tS
"}
(8,1,1) = {"
tS
OE
OE
pw
OE
OE
ix
ND
OE
OE
rX
OE
OE
OE
OE
OE
OE
tS
"}
(9,1,1) = {"
tS
OE
fb
OW
QM
pE
CG
fy
QM
wy
ut
QM
uG
gS
Pn
xp
OE
tS
"}
(10,1,1) = {"
tS
OE
OQ
vN
WQ
zw
zw
UR
Zm
fo
zw
UR
rb
OE
BQ
xU
OE
tS
"}
(11,1,1) = {"
tS
OE
OE
TH
OE
OE
OE
Op
OE
OE
OE
jX
OE
OE
OE
OE
OE
tS
"}
(12,1,1) = {"
tS
OE
Rt
hJ
qm
OE
bd
XH
ly
OE
zJ
zJ
Tp
LU
Dt
Aq
OE
tS
"}
(13,1,1) = {"
tS
OE
CU
hJ
wD
OE
jP
XH
XH
OE
Ur
zJ
Tp
nJ
KG
Tn
OE
tS
"}
(14,1,1) = {"
tS
OE
Gw
KL
ed
OE
tF
tF
fH
OE
fG
zJ
EW
nJ
qi
hw
OE
tS
"}
(15,1,1) = {"
tS
OE
PD
PD
MT
OE
tX
Ph
Au
OE
Ur
zJ
Tp
nJ
KG
Tn
OE
tS
"}
(16,1,1) = {"
tS
OE
aN
Ml
NC
OE
OE
OE
OE
OE
gP
UJ
CZ
Kq
Wj
qv
OE
tS
"}
(17,1,1) = {"
tS
OE
OE
OE
OE
OE
vT
vT
Si
OE
OE
OE
OE
OE
OE
OE
OE
tS
"}
(18,1,1) = {"
tS
tS
tS
tS
tS
tS
tS
tS
tS
tS
tS
tS
tS
tS
tS
tS
tS
tS
"}
