//MAP CONVERTED BY dmm2tgm.py THIS HEADER COMMENT PREVENTS RECONVERSION, DO NOT REMOVE
"ab" = (
/turf/open/space/bluespace,
/area/hilbertshotel)
"ad" = (
/turf/open/floor/catwalk_floor,
/area/hilbertshotel)
"ah" = (
/turf/closed/indestructible/wall,
/area/hilbertshotel)
"ai" = (
/obj/machinery/telecomms/relay/preset/auto,
/turf/open/floor/catwalk_floor,
/area/hilbertshotel)
"ao" = (
/obj/structure/table/wood/fancy,
/obj/structure/window/reinforced/tinted{
	dir = 1
	},
/obj/item/toy/plush/beeplushie,
/obj/item/flashlight/lamp/green{
	pixel_x = 5;
	pixel_y = 14
	},
/obj/effect/turf_decal/siding/wood/thin{
	dir = 1
	},
/turf/open/floor/carpet/purple,
/area/hilbertshotel)
"ap" = (
/obj/machinery/computer{
	dir = 4
	},
/turf/open/floor/carpet/purple,
/area/hilbertshotel)
"ax" = (
/obj/structure/lattice,
/turf/closed/indestructible/wall,
/area/hilbertshotel)
"aD" = (
/obj/effect/turf_decal/siding/wood/thin,
/turf/open/floor/carpet,
/area/hilbertshotel)
"aE" = (
/obj/effect/turf_decal/siding/wood/thin{
	dir = 4
	},
/turf/open/floor/wood/wood_tiled,
/area/hilbertshotel)
"aF" = (
/obj/effect/turf_decal/siding/wood/thin/corner{
	dir = 8
	},
/turf/open/floor/wood/wood_tiled,
/area/hilbertshotel)
"aH" = (
/obj/machinery/light{
	dir = 1
	},
/obj/structure/window,
/obj/structure/window,
/obj/structure/flora/junglebush,
/turf/open/floor/grass/grass0,
/area/hilbertshotel)
"aI" = (
/obj/effect/turf_decal/siding/wood/thin{
	dir = 10
	},
/turf/open/floor/carpet,
/area/hilbertshotel)
"aJ" = (
/obj/machinery/door/morgue,
/turf/open/floor/plasteel/dark,
/area/hilbertshotel)
"aK" = (
/turf/open/floor/plasteel/dark,
/area/hilbertshotel)
"aV" = (
/obj/structure/closet/cabinet{
	anchored = 1
	},
/obj/machinery/light{
	dir = 8
	},
/turf/open/floor/carpet/purple,
/area/hilbertshotel)
"aW" = (
/turf/open/floor/plasteel/stairs/medium,
/area/hilbertshotel)
"aX" = (
/turf/open/floor/plasteel/stairs/right,
/area/hilbertshotel)
"aY" = (
/obj/effect/turf_decal/siding/dark{
	dir = 10
	},
/turf/open/floor/plasteel/dark,
/area/hilbertshotel)
"ba" = (
/turf/open/indestructible/hoteltile,
/area/hilbertshotel)
"bb" = (
/obj/structure/mineral_door/paperframe,
/turf/open/indestructible/hoteltile,
/area/hilbertshotel)
"bd" = (
/obj/machinery/light{
	dir = 8
	},
/obj/effect/turf_decal/siding/wood/thin{
	dir = 8
	},
/turf/open/floor/wood/wood_tiled,
/area/hilbertshotel)
"be" = (
/obj/structure/chair/sofa/left/maroon{
	dir = 4
	},
/obj/effect/turf_decal/siding/wood/thin{
	dir = 8
	},
/turf/open/floor/carpet,
/area/hilbertshotel)
"bg" = (
/obj/structure/table/wood,
/obj/item/pizzabox/margherita{
	pixel_y = 11
	},
/turf/open/floor/carpet,
/area/hilbertshotel)
"bh" = (
/obj/structure/chair/sofa/right/maroon{
	dir = 8
	},
/obj/effect/turf_decal/siding/wood/thin{
	dir = 4
	},
/turf/open/floor/carpet,
/area/hilbertshotel)
"bi" = (
/turf/open/floor/plasteel/stairs{
	dir = 8
	},
/area/hilbertshotel)
"bj" = (
/obj/effect/turf_decal/siding/wood/thin/corner{
	dir = 8
	},
/obj/effect/turf_decal/siding/wood/thin{
	dir = 1
	},
/obj/machinery/light_switch/directional/north,
/turf/open/floor/wood/wood_tiled,
/area/hilbertshotel)
"bk" = (
/obj/structure/chair/office/dark{
	dir = 8
	},
/turf/open/floor/carpet/purple,
/area/hilbertshotel)
"bl" = (
/obj/structure/chair/sofa/corp/left{
	dir = 8
	},
/obj/effect/turf_decal/siding/wood/thin{
	dir = 4
	},
/obj/machinery/light{
	dir = 4
	},
/turf/open/floor/wood/wood_tiled,
/area/hilbertshotel)
"br" = (
/obj/structure/chair/sofa/middle/maroon{
	dir = 4
	},
/obj/effect/turf_decal/siding/wood/thin{
	dir = 8
	},
/turf/open/floor/carpet,
/area/hilbertshotel)
"bs" = (
/obj/structure/table/wood,
/obj/item/candle/infinite,
/obj/item/toy/cards/deck,
/turf/open/floor/carpet,
/area/hilbertshotel)
"bt" = (
/obj/structure/table/wood,
/obj/item/candle/infinite,
/turf/open/floor/carpet,
/area/hilbertshotel)
"bu" = (
/obj/structure/chair/sofa/middle/maroon{
	dir = 8
	},
/obj/effect/turf_decal/siding/wood/thin{
	dir = 4
	},
/turf/open/floor/carpet,
/area/hilbertshotel)
"bA" = (
/obj/structure/chair/sofa/right/maroon{
	dir = 4
	},
/obj/effect/turf_decal/siding/wood/thin{
	dir = 8
	},
/turf/open/floor/carpet,
/area/hilbertshotel)
"bB" = (
/obj/structure/table/wood,
/turf/open/floor/carpet,
/area/hilbertshotel)
"bD" = (
/obj/structure/chair/sofa/left/maroon{
	dir = 8
	},
/obj/effect/turf_decal/siding/wood/thin{
	dir = 4
	},
/turf/open/floor/carpet,
/area/hilbertshotel)
"bG" = (
/obj/structure/window/reinforced/tinted{
	dir = 1
	},
/obj/structure/dresser,
/obj/effect/turf_decal/siding/wood/thin{
	dir = 1
	},
/turf/open/floor/carpet/purple,
/area/hilbertshotel)
"bH" = (
/obj/effect/turf_decal/siding/wood/thin{
	dir = 1
	},
/turf/open/floor/carpet/purple,
/area/hilbertshotel)
"bJ" = (
/obj/machinery/light{
	dir = 4
	},
/obj/machinery/jukebox{
	req_one_access = null
	},
/obj/effect/turf_decal/siding/wood/thin{
	dir = 8
	},
/turf/open/floor/wood/wood_large,
/area/hilbertshotel)
"bK" = (
/obj/effect/turf_decal/siding/dark{
	dir = 8
	},
/turf/open/floor/plasteel/dark,
/area/hilbertshotel)
"bP" = (
/turf/open/floor/plasteel/stairs/right{
	dir = 1
	},
/area/hilbertshotel)
"bQ" = (
/obj/structure/chair/stool/bar,
/obj/effect/turf_decal/siding/wood/thin/corner,
/turf/open/floor/wood/wood_tiled,
/area/hilbertshotel)
"bZ" = (
/obj/structure/railing,
/obj/machinery/light/small{
	dir = 4
	},
/turf/open/pool,
/area/hilbertshotel)
"cb" = (
/obj/structure/chair/stool/bar,
/obj/effect/turf_decal/siding/wood/thin{
	dir = 8
	},
/turf/open/floor/wood/wood_tiled,
/area/hilbertshotel)
"cc" = (
/obj/structure/closet/crate/bin,
/obj/effect/turf_decal/siding/wood/thin,
/turf/open/floor/wood/wood_tiled,
/area/hilbertshotel)
"cd" = (
/obj/structure/table/wood/fancy,
/obj/item/flashlight/lamp/green{
	pixel_x = -7;
	pixel_y = 2
	},
/turf/open/floor/carpet/purple,
/area/hilbertshotel)
"cg" = (
/obj/structure/table/reinforced,
/obj/item/reagent_containers/food/drinks/drinkingglass{
	pixel_x = -5;
	pixel_y = 5
	},
/obj/item/reagent_containers/food/drinks/drinkingglass,
/obj/item/reagent_containers/food/drinks/drinkingglass{
	pixel_x = 5;
	pixel_y = 4
	},
/obj/item/reagent_containers/food/drinks/bottle/champagne,
/turf/open/floor/plasteel/cafeteria,
/area/hilbertshotel)
"ch" = (
/obj/structure/table/reinforced,
/turf/open/floor/plasteel/cafeteria,
/area/hilbertshotel)
"ci" = (
/obj/structure/table/reinforced,
/obj/machinery/light{
	dir = 4
	},
/obj/effect/spawner/lootdrop/three_course_meal,
/turf/open/floor/plasteel/cafeteria,
/area/hilbertshotel)
"cj" = (
/obj/machinery/light{
	dir = 8
	},
/turf/open/floor/plasteel/stairs/left{
	dir = 1
	},
/area/hilbertshotel)
"cl" = (
/obj/structure/table/reinforced,
/obj/machinery/microwave,
/obj/effect/turf_decal/siding/wideplating_new/light{
	dir = 1
	},
/turf/open/floor/mineral/titanium/tiled/white,
/area/hilbertshotel)
"cq" = (
/turf/open/floor/plasteel/cafeteria,
/area/hilbertshotel)
"cr" = (
/turf/open/floor/plasteel/stairs{
	dir = 4
	},
/area/hilbertshotel)
"cs" = (
/obj/machinery/light/small{
	dir = 1
	},
/turf/open/indestructible/hoteltile,
/area/hilbertshotel)
"ct" = (
/obj/structure/window/reinforced/tinted{
	dir = 4;
	icon_state = "twindow"
	},
/turf/open/indestructible/hoteltile,
/area/hilbertshotel)
"cu" = (
/turf/open/pool,
/area/hilbertshotel)
"cv" = (
/obj/machinery/shower{
	dir = 8
	},
/turf/open/pool,
/area/hilbertshotel)
"cw" = (
/obj/structure/table/reinforced,
/obj/structure/sink/kitchen/directional/east,
/obj/effect/turf_decal/siding/wideplating_new/light{
	dir = 5
	},
/turf/open/floor/mineral/titanium/tiled/white,
/area/hilbertshotel)
"cy" = (
/obj/structure/sink{
	dir = 8;
	pixel_x = -12;
	pixel_y = 2
	},
/obj/structure/mirror/directional/west,
/turf/open/indestructible/hoteltile,
/area/hilbertshotel)
"cz" = (
/obj/machinery/smartfridge/food,
/obj/effect/turf_decal/siding/wideplating_new/light{
	dir = 1
	},
/turf/open/floor/mineral/titanium/tiled/white,
/area/hilbertshotel)
"cB" = (
/obj/structure/toilet{
	dir = 4
	},
/obj/structure/window/reinforced/tinted{
	dir = 1
	},
/turf/open/indestructible/hoteltile,
/area/hilbertshotel)
"cF" = (
/turf/closed/indestructible/hoteldoor{
	icon_state = "door_closed";
	icon = 'icons/obj/doors/puzzledoor/default.dmi'
	},
/area/hilbertshotel)
"cJ" = (
/obj/structure/bed/double,
/obj/item/bedsheet/random/double,
/turf/open/floor/carpet/purple,
/area/hilbertshotel)
"dk" = (
/obj/structure/bookcase/random/adult,
/turf/open/floor/wood/wood_large,
/area/hilbertshotel)
"ep" = (
/obj/effect/turf_decal/siding/wood/thin/end{
	dir = 1
	},
/obj/item/kirbyplants/random,
/turf/open/floor/wood/wood_tiled,
/area/hilbertshotel)
"gQ" = (
/obj/effect/turf_decal/siding/dark/corner{
	dir = 8
	},
/turf/open/floor/plasteel/dark,
/area/hilbertshotel)
"hx" = (
/obj/machinery/vending/snack/orange{
	shut_up = 1
	},
/obj/effect/turf_decal/siding/wood/thin{
	dir = 8
	},
/turf/open/floor/wood/wood_large,
/area/hilbertshotel)
"ll" = (
/obj/effect/turf_decal/siding/dark{
	dir = 6
	},
/obj/structure/closet/cabinet,
/turf/open/floor/plasteel/dark,
/area/hilbertshotel)
"lm" = (
/obj/structure/chair/sofa/corp/left{
	dir = 1
	},
/obj/effect/turf_decal/siding/wood/thin/corner,
/turf/open/floor/wood/wood_tiled,
/area/hilbertshotel)
"lC" = (
/obj/effect/turf_decal/siding/wood/thin{
	dir = 6
	},
/turf/open/floor/carpet,
/area/hilbertshotel)
"lG" = (
/obj/structure/pole{
	pixel_y = 0;
	pixel_x = 0
	},
/turf/open/floor/light,
/area/hilbertshotel)
"mh" = (
/obj/structure/window,
/obj/structure/window,
/obj/structure/window,
/obj/structure/window{
	dir = 4
	},
/obj/structure/flora/junglebush/large,
/obj/structure/flora/junglebush,
/turf/open/floor/grass/grass0,
/area/hilbertshotel)
"no" = (
/obj/structure/window,
/obj/structure/window,
/obj/structure/flora/junglebush/large,
/obj/structure/flora/junglebush,
/turf/open/floor/grass/grass0,
/area/hilbertshotel)
"qX" = (
/obj/effect/turf_decal/siding/wood/thin{
	dir = 9
	},
/turf/open/floor/carpet,
/area/hilbertshotel)
"re" = (
/obj/structure/chair/sofa/corp/corner{
	dir = 8
	},
/obj/effect/turf_decal/siding/wood/thin{
	dir = 6
	},
/obj/structure/sign/poster/contraband/random{
	pixel_y = -32
	},
/turf/open/floor/wood/wood_tiled,
/area/hilbertshotel)
"rQ" = (
/obj/machinery/vending/kink{
	shut_up = 1
	},
/turf/open/floor/plasteel/dark,
/area/hilbertshotel)
"uG" = (
/obj/structure/table,
/obj/item/reagent_containers/rag/towel/syndicate{
	pixel_x = 5;
	pixel_y = 5
	},
/obj/item/reagent_containers/rag/towel/syndicate{
	pixel_x = -5;
	pixel_y = 5
	},
/obj/item/reagent_containers/rag/towel/syndicate,
/turf/open/indestructible/hoteltile,
/area/hilbertshotel)
"CL" = (
/obj/effect/turf_decal/siding/dark/corner,
/turf/open/floor/plasteel/dark,
/area/hilbertshotel)
"CV" = (
/obj/structure/railing/corner,
/obj/structure/pool/ladder{
	dir = 1;
	pixel_y = -22;
	pixel_x = 0
	},
/turf/open/pool,
/area/hilbertshotel)
"Fk" = (
/turf/open/floor/wood/wood_tiled,
/area/hilbertshotel)
"Ge" = (
/obj/structure/window,
/obj/structure/window,
/obj/structure/window,
/obj/structure/window{
	dir = 8;
	icon_state = "window"
	},
/obj/structure/flora/junglebush,
/turf/open/floor/grass/grass0,
/area/hilbertshotel)
"Gy" = (
/obj/effect/turf_decal/siding/wood/thin/corner{
	dir = 4
	},
/obj/effect/turf_decal/siding/wood/thin/corner,
/turf/open/floor/wood/wood_tiled,
/area/hilbertshotel)
"Is" = (
/obj/effect/turf_decal/siding/wood/thin/corner{
	dir = 4
	},
/turf/open/floor/wood/wood_tiled,
/area/hilbertshotel)
"IT" = (
/turf/open/floor/carpet/purple,
/area/hilbertshotel)
"Kv" = (
/obj/effect/turf_decal/siding/dark{
	dir = 4
	},
/obj/machinery/light_switch/directional/east,
/obj/structure/rack,
/turf/open/floor/plasteel/dark,
/area/hilbertshotel)
"MA" = (
/obj/structure/sign/poster/contraband/random,
/turf/closed/indestructible/wall,
/area/hilbertshotel)
"Oe" = (
/obj/machinery/vending/boozeomat{
	shut_up = 1
	},
/obj/effect/turf_decal/siding/wideplating_new/light/corner{
	dir = 4
	},
/turf/open/floor/mineral/titanium/tiled/white,
/area/hilbertshotel)
"Os" = (
/obj/effect/turf_decal/siding/wood/thin{
	dir = 5
	},
/turf/open/floor/carpet,
/area/hilbertshotel)
"RP" = (
/obj/structure/bed/dogbed,
/obj/effect/turf_decal/siding/wood/thin{
	dir = 8
	},
/turf/open/floor/wood/wood_tiled,
/area/hilbertshotel)
"TU" = (
/obj/machinery/vending/games{
	shut_up = 1
	},
/obj/effect/turf_decal/siding/wood/thin{
	dir = 8
	},
/turf/open/floor/wood/wood_large,
/area/hilbertshotel)
"VG" = (
/obj/effect/turf_decal/siding/wood/thin{
	dir = 9
	},
/turf/open/floor/wood/wood_tiled,
/area/hilbertshotel)
"Wy" = (
/obj/effect/turf_decal/siding/wood/thin/corner{
	dir = 1
	},
/turf/open/floor/wood/wood_tiled,
/area/hilbertshotel)
"WF" = (
/obj/structure/mineral_door/wood,
/obj/effect/turf_decal/siding/wood/thin{
	dir = 1
	},
/obj/effect/turf_decal/siding/wood/thin,
/turf/open/floor/wood/wood_tiled,
/area/hilbertshotel)
"WN" = (
/obj/structure/chair/stool/bar,
/turf/open/floor/wood/wood_tiled,
/area/hilbertshotel)
"Xu" = (
/obj/effect/turf_decal/siding/wood/thin/corner{
	dir = 1
	},
/obj/effect/turf_decal/siding/wood/thin{
	dir = 4
	},
/turf/open/floor/wood/wood_tiled,
/area/hilbertshotel)
"Ye" = (
/turf/open/floor/plasteel/stairs/left,
/area/hilbertshotel)
"Zh" = (
/obj/effect/turf_decal/siding/wood/thin{
	dir = 8
	},
/turf/open/floor/wood/wood_tiled,
/area/hilbertshotel)
"Zj" = (
/obj/effect/turf_decal/siding/wood/thin{
	dir = 1
	},
/turf/open/floor/carpet,
/area/hilbertshotel)

(1,1,1) = {"
ab
ab
ab
ab
ab
ab
ab
ab
ab
ab
ab
ab
ab
ab
ab
"}
(2,1,1) = {"
ab
ah
ah
ah
MA
ah
ah
ah
ah
ah
ah
ah
ah
ah
ab
"}
(3,1,1) = {"
ab
ax
dk
VG
bd
Zh
Zh
Zh
cb
cg
cq
cw
Oe
ah
ab
"}
(4,1,1) = {"
ab
ax
Ge
qX
be
br
bA
aI
WN
ch
cq
cq
cl
ah
ab
"}
(5,1,1) = {"
ab
ax
no
Zj
bB
bs
bB
aD
bQ
ci
cq
cq
cz
ah
ab
"}
(6,1,1) = {"
ab
ax
aH
Zj
bg
bt
bB
aD
cc
ah
cr
ah
ah
ah
ab
"}
(7,1,1) = {"
ab
ah
mh
Os
bh
bu
bD
lC
aF
cj
gQ
bK
aY
cF
ab
"}
(8,1,1) = {"
ab
ah
ep
Xu
Gy
aE
Is
Fk
Fk
bP
CL
Kv
ll
ah
ab
"}
(9,1,1) = {"
ab
ah
ah
ah
bi
ah
TU
hx
bJ
ah
bb
ah
ah
ah
ab
"}
(10,1,1) = {"
ab
ah
rQ
ah
WF
ah
ah
ah
ah
ah
ba
cy
cB
ah
ab
"}
(11,1,1) = {"
ab
ah
aJ
ah
bj
RP
bG
aV
ap
ah
cs
ba
ba
ah
ab
"}
(12,1,1) = {"
ab
ah
aK
Ye
Wy
Fk
bH
IT
bk
ah
ct
ct
ba
ah
ab
"}
(13,1,1) = {"
ab
ah
lG
aW
Fk
lm
ao
cJ
cd
ah
cu
CV
ba
ah
ab
"}
(14,1,1) = {"
ab
ah
aK
aX
bl
re
ah
ah
ah
ah
cv
bZ
uG
ah
ab
"}
(15,1,1) = {"
ab
ah
ah
ah
ah
ah
ah
ai
ad
ah
ah
ah
ah
ah
ab
"}
(16,1,1) = {"
ab
ab
ab
ab
ab
ab
ab
ab
ab
ab
ab
ab
ab
ab
ab
"}
