//MAP CONVERTED BY dmm2tgm.py THIS HEADER COMMENT PREVENTS RECONVERSION, DO NOT REMOVE
"bs" = (
/obj/structure/chair/sofa/left/maroon{
	dir = 8
	},
/turf/open/floor/wood/damturf/broken6,
/area/ruin/space/bluemoon)
"bY" = (
/obj/effect/decal/cleanable/blood/gibs/limb,
/turf/open/floor/plasteel,
/area/ruin/space/bluemoon)
"dO" = (
/obj/machinery/light/dim/directional/east,
/obj/effect/decal/cleanable/blood/gibs,
/turf/open/floor/plasteel,
/area/ruin/space/bluemoon)
"dU" = (
/turf/open/floor/plasteel,
/area/ruin/space/bluemoon)
"fS" = (
/obj/structure/curtain/goliath,
/obj/structure/window/reinforced/tinted{
	dir = 1
	},
/obj/structure/window/reinforced/tinted,
/mob/living/simple_animal/hostile/mannequin/abomination,
/turf/open/floor/plasteel,
/area/ruin/space/bluemoon)
"gr" = (
/turf/open/floor/wood/damturf/broken2,
/area/ruin/space/bluemoon)
"gS" = (
/obj/item/stack/spacecash/c1000,
/obj/machinery/light/dim/directional/east,
/turf/open/floor/plasteel,
/area/ruin/space/bluemoon)
"hk" = (
/obj/structure/table/wood,
/obj/effect/spawner/lootdrop/grille_or_trash,
/obj/item/stack/spacecash/c10,
/obj/item/stack/spacecash/c10,
/turf/open/floor/wood/damturf/broken2,
/area/ruin/space/bluemoon)
"iI" = (
/turf/open/floor/plasteel/damturf/damage2,
/area/ruin/space/bluemoon)
"iP" = (
/obj/effect/decal/cleanable/blood/gibs/human/body,
/turf/open/floor/plasteel,
/area/ruin/space/bluemoon)
"kp" = (
/obj/structure/sign/poster/contraband/robust_softdrinks,
/turf/closed/wall,
/area/ruin/space/bluemoon)
"ml" = (
/turf/open/floor/wood/damturf/broken5,
/area/ruin/space/bluemoon)
"nU" = (
/obj/structure/chair/sofa/left/maroon{
	dir = 4
	},
/turf/open/floor/wood/damturf/broken5,
/area/ruin/space/bluemoon)
"nY" = (
/obj/structure/window/reinforced{
	dir = 8
	},
/turf/open/floor/plasteel,
/area/ruin/space/bluemoon)
"ob" = (
/obj/machinery/light/dim/directional/west,
/turf/open/floor/plasteel,
/area/ruin/space/bluemoon)
"oe" = (
/obj/structure/window/reinforced{
	dir = 1
	},
/obj/structure/window/reinforced,
/obj/machinery/light/dim/directional/west,
/turf/open/floor/plasteel,
/area/ruin/space/bluemoon)
"oE" = (
/obj/structure/closet/crate/bin,
/turf/open/floor/wood/damturf/broken5,
/area/ruin/space/bluemoon)
"qZ" = (
/obj/structure/sign/poster/contraband/borg_fancy_1,
/turf/closed/wall/r_wall,
/area/ruin/space/bluemoon)
"rt" = (
/turf/open/floor/wood/damturf/broken3,
/area/ruin/space/bluemoon)
"rL" = (
/obj/effect/decal/cleanable/dirt/dust,
/turf/closed/wall,
/area/ruin/space/bluemoon)
"sa" = (
/obj/effect/decal/cleanable/blood/gibs/limb,
/turf/open/floor/plasteel/damturf/damage1,
/area/ruin/space/bluemoon)
"sk" = (
/turf/closed/wall,
/area/ruin/space/bluemoon)
"sq" = (
/obj/effect/decal/cleanable/dirt/dust,
/obj/structure/window/reinforced{
	dir = 8
	},
/turf/open/floor/plasteel,
/area/ruin/space/bluemoon)
"sN" = (
/obj/machinery/light/dim/directional/east,
/turf/open/floor/plasteel,
/area/ruin/space/bluemoon)
"sU" = (
/obj/effect/decal/cleanable/dirt/dust,
/obj/item/broken_bottle,
/turf/open/floor/plasteel,
/area/ruin/space/bluemoon)
"tg" = (
/obj/structure/lattice/catwalk,
/obj/structure/marker_beacon/jade,
/turf/open/space/basic,
/area/ruin/space/bluemoon)
"uV" = (
/obj/structure/fluff/broken_flooring,
/turf/open/space/basic,
/area/ruin/space/bluemoon)
"vm" = (
/obj/effect/decal/cleanable/blood/gibs,
/turf/open/floor/plasteel/damturf/damage2,
/area/ruin/space/bluemoon)
"wL" = (
/obj/structure/sign/poster/official/obey,
/turf/closed/wall/r_wall,
/area/ruin/space/bluemoon)
"wX" = (
/obj/structure/window/reinforced,
/turf/open/floor/plasteel,
/area/ruin/space/bluemoon)
"xj" = (
/obj/item/statuebust,
/turf/open/floor/plasteel,
/area/ruin/space/bluemoon)
"xW" = (
/obj/effect/decal/cleanable/blood/gibs,
/turf/open/floor/wood/damturf/broken1,
/area/ruin/space/bluemoon)
"zl" = (
/obj/structure/door_assembly,
/turf/open/floor/plasteel,
/area/ruin/space/bluemoon)
"zU" = (
/obj/structure/curtain/goliath,
/obj/structure/window/reinforced/tinted,
/obj/structure/window/reinforced/tinted{
	dir = 1
	},
/obj/effect/spawner/lootdrop/statuesevil,
/turf/open/floor/plasteel,
/area/ruin/space/bluemoon)
"AN" = (
/obj/structure/chair/sofa/right/maroon{
	dir = 4
	},
/obj/machinery/light/dim/directional/west,
/turf/open/floor/wood/damturf/broken1,
/area/ruin/space/bluemoon)
"AV" = (
/obj/structure/fans/tiny/invisible,
/obj/effect/decal/cleanable/dirt/dust,
/turf/open/floor/plasteel,
/area/ruin/space/bluemoon)
"Bz" = (
/obj/machinery/vending/cola,
/turf/open/floor/plasteel,
/area/ruin/space/bluemoon)
"BY" = (
/obj/effect/decal/cleanable/dirt/dust,
/obj/item/trash/tray,
/turf/open/floor/plasteel,
/area/ruin/space/bluemoon)
"CC" = (
/obj/effect/spawner/structure/window/reinforced/no_firelock,
/turf/open/floor/plasteel,
/area/ruin/space/bluemoon)
"El" = (
/obj/effect/spawner/lootdrop/statuesevil,
/obj/structure/window/reinforced,
/obj/structure/window/reinforced{
	dir = 8
	},
/obj/structure/window/reinforced{
	dir = 1
	},
/turf/open/floor/plasteel,
/area/ruin/space/bluemoon)
"EB" = (
/obj/structure/sign/poster/contraband/starkist,
/turf/closed/wall,
/area/ruin/space/bluemoon)
"EN" = (
/obj/machinery/vending/coffee,
/turf/open/floor/plasteel,
/area/ruin/space/bluemoon)
"Fi" = (
/obj/item/stack/spacecash/c1000,
/turf/open/floor/plating,
/area/ruin/space/bluemoon)
"FA" = (
/obj/effect/mob_spawn/human/corpse/cargo_tech,
/obj/effect/decal/cleanable/blood/gibs,
/turf/open/floor/plasteel,
/area/ruin/space/bluemoon)
"FE" = (
/obj/effect/decal/cleanable/dirt/dust,
/obj/effect/spawner/lootdrop/statuesevil,
/obj/structure/window/reinforced{
	dir = 8
	},
/obj/structure/window/reinforced{
	dir = 1
	},
/obj/structure/window/reinforced,
/turf/open/floor/plasteel,
/area/ruin/space/bluemoon)
"GI" = (
/obj/structure/sign/poster/contraband/bread,
/turf/closed/wall/r_wall,
/area/ruin/space/bluemoon)
"Hq" = (
/obj/effect/decal/cleanable/dirt/dust,
/turf/open/floor/plasteel,
/area/ruin/space/bluemoon)
"HH" = (
/obj/effect/decal/cleanable/blood/gibs,
/turf/open/floor/plasteel,
/area/ruin/space/bluemoon)
"IJ" = (
/obj/effect/mob_spawn/human/corpse/assistant,
/turf/open/floor/plasteel,
/area/ruin/space/bluemoon)
"IY" = (
/turf/open/floor/plasteel/damturf/damage4,
/area/ruin/space/bluemoon)
"Jt" = (
/obj/item/trash/candy,
/turf/open/floor/plasteel,
/area/ruin/space/bluemoon)
"Kc" = (
/obj/structure/curtain/goliath,
/obj/structure/window/reinforced/tinted,
/obj/structure/window/reinforced/tinted{
	dir = 1
	},
/mob/living/simple_animal/hostile/mannequin/damaged,
/turf/open/floor/plasteel,
/area/ruin/space/bluemoon)
"Kj" = (
/obj/machinery/door/airlock/multi_tile/glass,
/obj/effect/decal/cleanable/dirt/dust,
/turf/open/floor/plasteel,
/area/ruin/space/bluemoon)
"Kl" = (
/obj/machinery/light/dim/directional/south,
/obj/effect/decal/cleanable/blood/gibs,
/turf/open/floor/plasteel,
/area/ruin/space/bluemoon)
"KB" = (
/obj/structure/fluff/iced_abductor,
/turf/open/floor/plasteel,
/area/ruin/space/bluemoon)
"Lf" = (
/obj/structure/closet/crate/bin,
/turf/open/floor/plasteel,
/area/ruin/space/bluemoon)
"Lh" = (
/turf/closed/wall/r_wall,
/area/ruin/space/bluemoon)
"Lq" = (
/obj/structure/window/reinforced/tinted,
/obj/structure/window/reinforced/tinted{
	dir = 1
	},
/obj/structure/table/reinforced,
/obj/item/storage/toolbox/gold_fake,
/turf/open/floor/plasteel,
/area/ruin/space/bluemoon)
"Ls" = (
/obj/effect/spawner/lootdrop/grille_or_trash,
/turf/open/floor/plasteel,
/area/ruin/space/bluemoon)
"Mg" = (
/obj/structure/lattice/catwalk,
/turf/open/space/basic,
/area/ruin/space/bluemoon)
"MJ" = (
/obj/structure/statue/bananium/clown,
/turf/open/floor/plasteel,
/area/ruin/space/bluemoon)
"Pp" = (
/obj/effect/spawner/lootdrop/mannequin,
/turf/open/floor/plating,
/area/ruin/space/bluemoon)
"PD" = (
/turf/open/space/basic,
/area/template_noop)
"PQ" = (
/obj/structure/window/reinforced{
	dir = 8
	},
/obj/effect/spawner/lootdrop/grille_or_trash,
/turf/open/floor/plasteel,
/area/ruin/space/bluemoon)
"QR" = (
/turf/open/floor/plating,
/area/ruin/space/bluemoon)
"Re" = (
/obj/structure/curtain/goliath,
/obj/structure/window/reinforced/tinted,
/obj/structure/window/reinforced/tinted{
	dir = 1
	},
/obj/structure/window/reinforced/tinted/frosted{
	dir = 8
	},
/mob/living/simple_animal/hostile/mannequin/bloodlust,
/turf/open/floor/plasteel,
/area/ruin/space/bluemoon)
"Sf" = (
/obj/effect/decal/cleanable/dirt/dust,
/obj/machinery/light/dim/directional/east,
/turf/open/floor/plasteel/damturf/damage2,
/area/ruin/space/bluemoon)
"SE" = (
/obj/structure/falsewall/reinforced,
/turf/open/floor/plating,
/area/ruin/space/bluemoon)
"UF" = (
/turf/open/floor/plasteel/damturf/damage5,
/area/ruin/space/bluemoon)
"UN" = (
/obj/machinery/door/airlock/abandoned,
/turf/open/floor/plasteel,
/area/ruin/space/bluemoon)
"US" = (
/obj/structure/chair/sofa/right/maroon{
	dir = 8
	},
/turf/open/floor/wood/damturf/broken3,
/area/ruin/space/bluemoon)
"VW" = (
/obj/structure/window/reinforced,
/obj/structure/window/reinforced{
	dir = 1
	},
/turf/open/floor/plasteel,
/area/ruin/space/bluemoon)
"Wm" = (
/turf/open/floor/wood/damturf/broken7,
/area/ruin/space/bluemoon)
"Wr" = (
/obj/effect/decal/cleanable/dirt/dust,
/turf/open/floor/plasteel/damturf/damage2,
/area/ruin/space/bluemoon)
"WA" = (
/obj/structure/curtain/goliath,
/obj/structure/window/reinforced/tinted{
	dir = 1
	},
/obj/structure/window/reinforced/tinted,
/obj/effect/spawner/lootdrop/statuesevil,
/turf/open/floor/plasteel,
/area/ruin/space/bluemoon)
"WK" = (
/obj/effect/decal/cleanable/dirt/dust,
/obj/machinery/light/dim/directional/west,
/turf/open/floor/plasteel,
/area/ruin/space/bluemoon)
"XF" = (
/obj/machinery/firealarm/directional/east,
/turf/open/floor/plasteel,
/area/ruin/space/bluemoon)
"XL" = (
/obj/effect/decal/cleanable/dirt/dust,
/obj/effect/decal/cleanable/blood/gibs,
/obj/effect/decal/cleanable/blood/gibs/limb,
/turf/open/floor/plasteel,
/area/ruin/space/bluemoon)
"YQ" = (
/obj/structure/table/wood,
/obj/item/toy/cards/deck,
/turf/open/floor/wood/damturf/broken2,
/area/ruin/space/bluemoon)
"YR" = (
/obj/structure/statue/bronze/marx,
/turf/open/floor/plasteel,
/area/ruin/space/bluemoon)
"YX" = (
/mob/living/simple_animal/hostile/cult/mannequin,
/turf/open/floor/wood/damturf/broken7,
/area/ruin/space/bluemoon)
"Zd" = (
/obj/machinery/vending/snack/teal,
/turf/open/floor/plasteel,
/area/ruin/space/bluemoon)
"Ze" = (
/obj/effect/mob_spawn/human/corpse/cargo_tech,
/turf/open/floor/plasteel,
/area/ruin/space/bluemoon)
"ZE" = (
/obj/item/trash/boritos,
/turf/open/floor/wood/damturf/broken2,
/area/ruin/space/bluemoon)

(1,1,1) = {"
PD
PD
PD
PD
PD
PD
PD
PD
PD
PD
PD
PD
PD
PD
PD
PD
PD
PD
PD
PD
PD
PD
PD
PD
PD
PD
PD
PD
PD
PD
"}
(2,1,1) = {"
PD
PD
PD
PD
PD
PD
PD
PD
PD
PD
PD
PD
PD
PD
PD
PD
PD
PD
PD
PD
PD
PD
PD
PD
PD
PD
PD
PD
PD
PD
"}
(3,1,1) = {"
PD
PD
PD
PD
PD
PD
PD
PD
PD
PD
PD
PD
PD
PD
PD
PD
PD
PD
PD
PD
PD
PD
PD
PD
PD
PD
PD
PD
PD
PD
"}
(4,1,1) = {"
PD
PD
PD
PD
PD
PD
PD
PD
Lh
Lh
Lh
Lh
Lh
Lh
Lh
Lh
Lh
PD
PD
PD
PD
PD
PD
PD
PD
PD
PD
PD
PD
PD
"}
(5,1,1) = {"
PD
PD
PD
PD
PD
PD
PD
PD
Lh
xW
Wm
nU
AN
Wm
sk
dU
Lh
Lh
Lh
uV
dU
Lh
Lh
PD
PD
PD
PD
PD
PD
PD
"}
(6,1,1) = {"
PD
PD
PD
PD
PD
PD
PD
PD
Lh
rt
ml
hk
YQ
YX
sk
Hq
Ls
Hq
ob
dU
Hq
sU
Lh
PD
PD
PD
PD
PD
PD
PD
"}
(7,1,1) = {"
PD
PD
PD
PD
PD
PD
PD
PD
Lh
gr
ZE
US
bs
oE
sk
dU
dU
IY
HH
dU
Hq
Hq
Kj
Mg
Mg
Mg
Mg
Mg
Mg
PD
"}
(8,1,1) = {"
PD
PD
PD
PD
PD
PD
PD
PD
Lh
sk
zl
sk
sk
rL
sk
dU
Hq
dU
Hq
iI
Ls
Hq
AV
Mg
Mg
Mg
Mg
Mg
Mg
tg
"}
(9,1,1) = {"
PD
PD
PD
PD
Lh
Lh
Lh
Lh
wL
Ze
iP
bY
sN
dU
UN
Jt
sN
XF
dU
dU
sN
dU
Lh
PD
PD
PD
PD
PD
PD
PD
"}
(10,1,1) = {"
PD
PD
PD
PD
Lh
Pp
Fi
Pp
Lh
Bz
iI
dU
sk
UN
rL
sk
sk
sk
sk
sk
sk
sk
Lh
PD
PD
PD
PD
PD
PD
PD
"}
(11,1,1) = {"
PD
PD
PD
PD
Lh
Fi
Pp
QR
SE
Zd
HH
dU
sk
dU
sk
HH
wX
xj
oe
YR
VW
MJ
Lh
PD
PD
PD
PD
PD
PD
PD
"}
(12,1,1) = {"
PD
PD
PD
PD
Lh
Pp
Fi
Pp
Lh
EN
iI
Kl
sk
iI
zl
dU
Wr
sq
dU
PQ
dU
nY
CC
PD
PD
PD
PD
PD
PD
PD
"}
(13,1,1) = {"
PD
PD
PD
PD
Lh
Lh
Lh
Lh
Lh
dU
dU
dU
sk
dU
sk
dU
FA
Hq
XL
dU
UF
dU
CC
PD
PD
PD
PD
PD
PD
PD
"}
(14,1,1) = {"
PD
PD
PD
PD
PD
PD
PD
PD
Lh
sk
sk
UN
sk
zl
sk
dU
Ls
dU
Hq
dU
Ze
dU
CC
PD
PD
PD
PD
PD
PD
PD
"}
(15,1,1) = {"
PD
PD
PD
PD
PD
PD
PD
PD
Lh
Lf
WK
dU
Kc
Hq
rL
Hq
Sf
FE
BY
El
dO
dU
CC
PD
PD
PD
PD
PD
PD
PD
"}
(16,1,1) = {"
PD
PD
PD
PD
PD
PD
PD
PD
qZ
dU
dU
dU
dU
dU
sk
sk
sk
kp
sk
sk
EB
sk
Lh
PD
PD
PD
PD
PD
PD
PD
"}
(17,1,1) = {"
PD
PD
PD
PD
PD
PD
PD
PD
Lh
dU
vm
dU
iP
iI
dU
bY
dU
dU
dU
dU
IJ
dU
Lh
PD
PD
PD
PD
PD
PD
PD
"}
(18,1,1) = {"
PD
PD
PD
PD
PD
PD
PD
PD
GI
dU
dU
sa
dU
dU
dU
dU
dU
iP
dU
dU
dU
dU
Lh
PD
PD
PD
PD
PD
PD
PD
"}
(19,1,1) = {"
PD
PD
PD
PD
PD
PD
PD
PD
Lh
Re
dU
KB
gS
Lq
dU
zU
sN
WA
dU
fS
sN
zU
Lh
PD
PD
PD
PD
PD
PD
PD
"}
(20,1,1) = {"
PD
PD
PD
PD
PD
PD
PD
PD
Lh
Lh
Lh
Lh
Lh
Lh
Lh
Lh
Lh
Lh
Lh
Lh
Lh
Lh
Lh
PD
PD
PD
PD
PD
PD
PD
"}
(21,1,1) = {"
PD
PD
PD
PD
PD
PD
PD
PD
PD
PD
PD
PD
PD
PD
PD
PD
PD
PD
PD
PD
PD
PD
PD
PD
PD
PD
PD
PD
PD
PD
"}
(22,1,1) = {"
PD
PD
PD
PD
PD
PD
PD
PD
PD
PD
PD
PD
PD
PD
PD
PD
PD
PD
PD
PD
PD
PD
PD
PD
PD
PD
PD
PD
PD
PD
"}
(23,1,1) = {"
PD
PD
PD
PD
PD
PD
PD
PD
PD
PD
PD
PD
PD
PD
PD
PD
PD
PD
PD
PD
PD
PD
PD
PD
PD
PD
PD
PD
PD
PD
"}
(24,1,1) = {"
PD
PD
PD
PD
PD
PD
PD
PD
PD
PD
PD
PD
PD
PD
PD
PD
PD
PD
PD
PD
PD
PD
PD
PD
PD
PD
PD
PD
PD
PD
"}
