//MAP CONVERTED BY dmm2tgm.py THIS HEADER COMMENT PREVENTS RECONVERSION, DO NOT REMOVE
"a" = (
/turf/open/floor/pod{
	initial_gas_mix = "o2=14;n2=23;TEMP=300"
	},
/area/awaymission/PactDaivers)
"e" = (
/obj/structure/fence/corner{
	dir = 9
	},
/turf/open/indestructible/ironsand,
/area/awaymission/PactDaivers)
"f" = (
/mob/living/simple_animal/hostile/syndicate/mecha_pilot/inteq/light,
/turf/open/indestructible/ironsand,
/area/awaymission/PactDaivers)
"i" = (
/obj/structure/fence/door{
	dir = 4
	},
/turf/open/indestructible/ironsand,
/area/awaymission/PactDaivers)
"r" = (
/obj/structure/fence{
	dir = 4
	},
/turf/open/indestructible/ironsand,
/area/awaymission/PactDaivers)
"B" = (
/turf/open/indestructible/ironsand,
/area/awaymission/PactDaivers)
"G" = (
/mob/living/simple_animal/hostile/syndicate/ranged/smg/space,
/turf/open/indestructible/ironsand,
/area/awaymission/PactDaivers)
"H" = (
/obj/structure/fence,
/turf/open/indestructible/ironsand,
/area/awaymission/PactDaivers)
"T" = (
/turf/closed/mineral/ash_rock,
/area/awaymission/PactDaivers)
"V" = (
/obj/structure/hellgate_beacon/deployed{
	pixel_y = -1;
	pixel_x = -9;
	name = "Сенсорный датчик"
	},
/turf/open/floor/pod{
	initial_gas_mix = "o2=14;n2=23;TEMP=300"
	},
/area/awaymission/PactDaivers)

(1,1,1) = {"
B
B
B
B
B
B
B
B
B
B
B
B
B
B
B
B
B
B
B
B
"}
(2,1,1) = {"
B
B
B
B
B
B
B
B
B
B
B
B
B
B
B
B
B
B
B
B
"}
(3,1,1) = {"
B
B
B
B
B
G
B
B
B
B
f
B
B
B
B
B
B
B
B
B
"}
(4,1,1) = {"
B
B
B
B
B
B
B
B
B
B
B
B
B
B
B
B
B
B
B
B
"}
(5,1,1) = {"
B
B
B
B
B
B
B
B
B
B
B
B
B
B
G
B
B
T
T
B
"}
(6,1,1) = {"
B
B
G
B
e
H
H
H
H
i
H
H
H
H
H
T
T
T
T
B
"}
(7,1,1) = {"
B
B
B
B
r
B
B
B
B
B
B
B
a
a
a
T
T
T
T
B
"}
(8,1,1) = {"
B
B
B
B
r
B
B
B
B
B
B
B
a
V
a
T
T
T
T
B
"}
(9,1,1) = {"
B
B
B
B
r
B
B
B
B
B
B
B
a
a
a
B
T
T
B
B
"}
(10,1,1) = {"
B
B
B
B
r
B
B
B
B
B
B
B
B
B
B
B
T
B
B
B
"}
(11,1,1) = {"
B
B
B
B
r
B
a
a
a
B
B
B
B
B
B
T
T
B
B
B
"}
(12,1,1) = {"
B
B
B
G
r
B
a
V
a
B
B
B
B
B
B
T
T
B
B
B
"}
(13,1,1) = {"
T
T
B
B
r
B
a
a
a
B
B
B
B
B
T
T
T
B
B
B
"}
(14,1,1) = {"
T
T
T
T
r
B
B
B
B
B
B
B
B
T
T
T
B
B
B
B
"}
(15,1,1) = {"
B
T
T
T
T
B
B
B
B
B
B
B
B
T
T
B
B
B
B
B
"}
(16,1,1) = {"
B
T
T
T
T
T
T
T
B
B
B
B
B
T
T
B
B
B
B
B
"}
(17,1,1) = {"
B
B
T
T
T
T
T
T
T
T
T
T
T
T
T
B
B
B
B
B
"}
(18,1,1) = {"
B
B
B
B
T
T
T
T
T
T
T
T
T
T
B
B
B
B
B
B
"}
(19,1,1) = {"
B
B
B
B
B
B
B
T
T
B
T
T
T
B
B
B
B
B
B
B
"}
(20,1,1) = {"
B
B
B
B
B
B
B
B
B
B
B
B
B
B
B
B
B
B
B
B
"}
