//MAP CONVERTED BY dmm2tgm.py THIS HEADER COMMENT PREVENTS RECONVERSION, DO NOT REMOVE
"aj" = (
/obj/structure/barricade/sandbags,
/turf/open/indestructible/ironsand,
/area/awaymission/PactDaivers)
"aD" = (
/obj/machinery/door/airlock/centcom{
	name = "Raiders Barracks";
	req_access_txt = "152"
	},
/obj/effect/turf_decal/tile/brown/opposingcorners,
/turf/open/floor/plasteel/dark,
/area/awaymission/PactDaivers)
"bA" = (
/obj/machinery/washing_machine,
/obj/effect/turf_decal/tile/dark_blue/fourcorners,
/obj/machinery/light/small{
	dir = 1
	},
/turf/open/floor/plasteel/dark,
/area/awaymission/PactDaivers)
"dg" = (
/obj/effect/decal/cleanable/dirt,
/obj/machinery/computer{
	dir = 1
	},
/turf/open/floor/mineral/plastitanium,
/area/awaymission/PactDaivers)
"dp" = (
/obj/structure/lattice,
/obj/structure/sign/poster/contraband/inteq/inteq_no_sex,
/turf/closed/indestructible/syndicate,
/area/awaymission/PactDaivers)
"eb" = (
/obj/structure/closet/syndicate/inteq,
/obj/effect/turf_decal/siding/wood{
	dir = 4
	},
/obj/item/bikehorn/rubberducky,
/obj/item/gun/ballistic/automatic/ak12,
/obj/item/gun/ballistic/automatic/ak12,
/turf/open/floor/wood,
/area/awaymission/PactDaivers)
"fe" = (
/obj/effect/decal/cleanable/dirt,
/turf/open/floor/mineral/plastitanium,
/area/awaymission/PactDaivers)
"gd" = (
/turf/open/floor/wood,
/area/awaymission/PactDaivers)
"gv" = (
/obj/structure/toilet{
	dir = 8
	},
/obj/machinery/door/window{
	dir = 8;
	icon_state = "right";
	name = "Tactical Toilet";
	opacity = 1
	},
/obj/structure/window/reinforced/tinted,
/obj/structure/sign/poster/contraband/inteq/inteq_no_sex{
	pixel_y = 34
	},
/mob/living/simple_animal/hostile/syndicate/civilian,
/turf/open/floor/plasteel/showroomfloor,
/area/awaymission/PactDaivers)
"hn" = (
/obj/structure/bed{
	dir = 8
	},
/obj/item/bedsheet/inteq{
	dir = 1
	},
/obj/effect/mob_spawn/human/inteqspace/PactDaivers,
/turf/open/floor/wood,
/area/awaymission/PactDaivers)
"ho" = (
/turf/open/floor/mineral/plastitanium,
/area/awaymission/PactDaivers)
"ig" = (
/obj/machinery/power/floodlight/lamppost/four,
/turf/open/indestructible/ironsand,
/area/awaymission/PactDaivers)
"ih" = (
/turf/open/floor/carpet/royalblack,
/area/awaymission/PactDaivers)
"jd" = (
/obj/machinery/computer{
	dir = 8
	},
/turf/open/floor/mineral/plastitanium,
/area/awaymission/PactDaivers)
"li" = (
/turf/closed/indestructible/fakeglass,
/area/awaymission/PactDaivers)
"ml" = (
/obj/structure/closet/syndicate/inteq,
/obj/machinery/light/small,
/obj/item/bikehorn/rubberducky,
/turf/open/floor/wood,
/area/awaymission/PactDaivers)
"mM" = (
/obj/effect/decal/cleanable/dirt,
/obj/structure/railing{
	dir = 8
	},
/turf/open/floor/mineral/plastitanium,
/area/awaymission/PactDaivers)
"nb" = (
/obj/effect/turf_decal/stripes{
	dir = 1;
	icon_state = "delivery_red"
	},
/obj/structure/rack{
	dir = 8
	},
/obj/item/storage/belt/military/inteq,
/obj/item/storage/belt/military/inteq,
/obj/item/storage/belt/military/inteq,
/turf/open/floor/mineral/plastitanium,
/area/awaymission/PactDaivers)
"nP" = (
/obj/machinery/door/airlock/centcom{
	name = "Raiders Barracks";
	req_access_txt = "152"
	},
/obj/effect/turf_decal/siding/wood{
	dir = 8
	},
/turf/open/floor/wood,
/area/awaymission/PactDaivers)
"pa" = (
/obj/structure/sign/flag/inteq,
/turf/closed/indestructible/syndicate,
/area/awaymission/PactDaivers)
"ph" = (
/obj/structure/rack{
	dir = 8
	},
/obj/effect/turf_decal/stripes{
	dir = 1;
	icon_state = "delivery_red"
	},
/obj/item/ammo_box/magazine/hellgate_c74,
/obj/item/ammo_box/magazine/hellgate_c74,
/obj/item/ammo_box/magazine/hellgate_c74,
/turf/open/floor/mineral/plastitanium,
/area/awaymission/PactDaivers)
"pN" = (
/obj/structure/closet/syndicate/inteq,
/obj/machinery/light{
	dir = 8
	},
/obj/effect/turf_decal/siding/wood{
	dir = 4
	},
/obj/item/bikehorn/rubberducky,
/obj/item/ammo_box/magazine/ak12,
/obj/item/ammo_box/magazine/ak12,
/obj/item/ammo_box/magazine/ak12,
/turf/open/floor/wood,
/area/awaymission/PactDaivers)
"pY" = (
/obj/structure/hellgate_campaign/tank,
/turf/open/floor/plating,
/area/awaymission/PactDaivers)
"qj" = (
/obj/item/kirbyplants/random,
/obj/effect/turf_decal/tile/brown/opposingcorners,
/turf/open/floor/plasteel/dark,
/area/awaymission/PactDaivers)
"qX" = (
/turf/closed/indestructible/syndicate,
/area/awaymission/PactDaivers)
"rx" = (
/obj/effect/decal/cleanable/cobweb,
/obj/machinery/computer,
/turf/open/floor/mineral/plastitanium,
/area/awaymission/PactDaivers)
"sb" = (
/obj/structure/rack{
	dir = 8
	},
/obj/effect/turf_decal/stripes{
	dir = 1;
	icon_state = "delivery_red"
	},
/obj/structure/sign/flag/inteq{
	pixel_x = 32;
	pixel_y = 27
	},
/obj/item/gun/ballistic/automatic/hellgate_c74,
/turf/open/floor/mineral/plastitanium,
/area/awaymission/PactDaivers)
"tD" = (
/obj/effect/decal/cleanable/dirt,
/obj/structure/rack{
	dir = 8
	},
/obj/item/gun/medbeam,
/turf/open/floor/carpet/royalblack,
/area/awaymission/PactDaivers)
"uC" = (
/mob/living/simple_animal/hostile/syndicate/ranged/infiltrator,
/turf/open/indestructible/ironsand,
/area/awaymission/PactDaivers)
"ve" = (
/obj/machinery/computer{
	dir = 1
	},
/turf/open/floor/mineral/plastitanium,
/area/awaymission/PactDaivers)
"vj" = (
/obj/structure/closet/syndicate/inteq,
/obj/effect/turf_decal/siding/wood{
	dir = 4
	},
/obj/item/bikehorn/rubberducky,
/obj/item/ammo_box/magazine/ak12,
/obj/item/ammo_box/magazine/ak12,
/obj/item/ammo_box/magazine/ak12,
/turf/open/floor/wood,
/area/awaymission/PactDaivers)
"vv" = (
/obj/structure/table/reinforced,
/obj/machinery/fax{
	fax_name = "Unknown Fax";
	name = "KK-28 Fax Machine"
	},
/turf/open/floor/mineral/plastitanium,
/area/awaymission/PactDaivers)
"vx" = (
/obj/machinery/door/airlock/external,
/turf/open/floor/plating,
/area/awaymission/PactDaivers)
"vG" = (
/obj/machinery/door/airlock/centcom{
	name = "Restroom";
	req_access_txt = "152"
	},
/obj/effect/turf_decal/tile/dark_blue/fourcorners,
/turf/open/floor/plasteel/dark,
/area/awaymission/PactDaivers)
"xW" = (
/obj/structure/railing{
	dir = 8
	},
/turf/open/floor/mineral/plastitanium,
/area/awaymission/PactDaivers)
"yE" = (
/obj/structure/table/wood,
/obj/machinery/computer/med_data/laptop{
	dir = 1
	},
/turf/open/floor/wood,
/area/awaymission/PactDaivers)
"yR" = (
/obj/effect/turf_decal/tile/brown/opposingcorners,
/obj/machinery/door/airlock/external,
/turf/open/floor/plasteel/dark,
/area/awaymission/PactDaivers)
"zM" = (
/obj/structure/table/wood,
/obj/item/flashlight/lamp/green,
/obj/machinery/light/small{
	dir = 8
	},
/turf/open/floor/wood,
/area/awaymission/PactDaivers)
"Ab" = (
/obj/effect/turf_decal/tile/brown/opposingcorners,
/mob/living/simple_animal/hostile/syndicate/ranged/infiltrator,
/turf/open/floor/plasteel/dark,
/area/awaymission/PactDaivers)
"Bc" = (
/obj/machinery/light/small{
	dir = 4
	},
/turf/open/floor/mineral/plastitanium,
/area/awaymission/PactDaivers)
"Bi" = (
/obj/effect/turf_decal/tile/brown/opposingcorners,
/obj/structure/table/reinforced,
/obj/item/storage/toolbox/electrical,
/turf/open/floor/plasteel/dark,
/area/awaymission/PactDaivers)
"BW" = (
/turf/open/floor/plasteel/showroomfloor,
/area/awaymission/PactDaivers)
"Cf" = (
/obj/machinery/computer,
/turf/open/floor/mineral/plastitanium,
/area/awaymission/PactDaivers)
"Ci" = (
/obj/structure/urinal{
	pixel_y = 32
	},
/turf/open/floor/plasteel/showroomfloor,
/area/awaymission/PactDaivers)
"Cv" = (
/obj/effect/decal/cleanable/dirt,
/turf/closed/indestructible/syndicate,
/area/awaymission/PactDaivers)
"Da" = (
/obj/structure/chair/office/light{
	dir = 4
	},
/turf/open/floor/mineral/plastitanium,
/area/awaymission/PactDaivers)
"Ds" = (
/obj/structure/table,
/obj/effect/turf_decal/tile/dark_blue/fourcorners,
/obj/item/storage/crayons,
/turf/open/floor/plasteel/dark,
/area/awaymission/PactDaivers)
"Fq" = (
/obj/machinery/button/door{
	id = "snowdingarage2";
	name = "garage door";
	pixel_x = -7;
	pixel_y = -24
	},
/turf/open/floor/mineral/plastitanium,
/area/awaymission/PactDaivers)
"FN" = (
/obj/effect/turf_decal/tile/brown/opposingcorners,
/mob/living/simple_animal/bot/cleanbot{
	faction = list("InteQ")
	},
/turf/open/floor/plasteel/dark,
/area/awaymission/PactDaivers)
"FU" = (
/obj/structure/table/reinforced,
/obj/item/paper_bin,
/obj/item/pen/fountain/captain,
/turf/open/floor/mineral/plastitanium,
/area/awaymission/PactDaivers)
"GC" = (
/obj/structure/sink{
	dir = 8;
	pixel_x = -12;
	pixel_y = 2
	},
/obj/structure/mirror{
	pixel_x = -28
	},
/turf/open/floor/plasteel/showroomfloor,
/area/awaymission/PactDaivers)
"Hj" = (
/obj/machinery/light{
	dir = 1
	},
/obj/effect/turf_decal/tile/brown/opposingcorners,
/turf/open/floor/plasteel/dark,
/area/awaymission/PactDaivers)
"HI" = (
/obj/machinery/shower{
	dir = 4
	},
/obj/item/soap/inteq,
/turf/open/floor/plasteel/showroomfloor,
/area/awaymission/PactDaivers)
"Jf" = (
/obj/machinery/light/small{
	dir = 4
	},
/obj/effect/decal/cleanable/dirt,
/turf/open/floor/mineral/plastitanium,
/area/awaymission/PactDaivers)
"JR" = (
/obj/effect/turf_decal/tile/brown/opposingcorners,
/obj/item/mmi/posibrain/inteq,
/obj/structure/table/reinforced,
/turf/open/floor/plasteel/dark,
/area/awaymission/PactDaivers)
"JS" = (
/turf/closed/indestructible/riveted,
/area/awaymission/PactDaivers)
"Ld" = (
/obj/machinery/button/door{
	id = "snowdingarage2";
	name = "garage door";
	pixel_x = -7;
	pixel_y = -24
	},
/turf/open/indestructible/ironsand,
/area/awaymission/PactDaivers)
"Ll" = (
/obj/machinery/light/small{
	dir = 1
	},
/turf/open/floor/carpet/royalblack,
/area/awaymission/PactDaivers)
"LG" = (
/obj/machinery/door/airlock/hatch,
/turf/open/floor/carpet/royalblack,
/area/awaymission/PactDaivers)
"Mk" = (
/obj/structure/bed,
/obj/item/bedsheet/inteq,
/turf/open/floor/wood,
/area/awaymission/PactDaivers)
"Ni" = (
/obj/structure/bed,
/obj/item/bedsheet/inteq,
/obj/effect/mob_spawn/human/inteqspace/PactDaivers,
/turf/open/floor/wood,
/area/awaymission/PactDaivers)
"Nl" = (
/obj/machinery/door/poddoor/shutters{
	id = "garage_cabin";
	name = "garage door"
	},
/turf/open/floor/plating,
/area/awaymission/PactDaivers)
"Ox" = (
/obj/structure/fans/tiny,
/obj/machinery/door/firedoor,
/obj/machinery/door/airlock/hatch,
/turf/open/floor/plasteel/bluespace,
/area/awaymission/PactDaivers)
"OH" = (
/obj/effect/turf_decal/tile/brown/opposingcorners,
/obj/structure/table/reinforced,
/obj/item/storage/toolbox/infiltrator/inteq,
/turf/open/floor/plasteel/dark,
/area/awaymission/PactDaivers)
"PK" = (
/turf/open/floor/plating,
/area/awaymission/PactDaivers)
"Qd" = (
/obj/effect/turf_decal/tile/brown/opposingcorners,
/obj/structure/table/reinforced,
/turf/open/floor/plasteel/dark,
/area/awaymission/PactDaivers)
"Qe" = (
/obj/effect/turf_decal/tile/dark_blue/fourcorners,
/turf/open/floor/plasteel/dark,
/area/awaymission/PactDaivers)
"QZ" = (
/obj/machinery/vending/inteq_vendomat{
	shut_up = 1
	},
/obj/effect/turf_decal/siding/wood{
	dir = 4
	},
/turf/open/floor/wood,
/area/awaymission/PactDaivers)
"Rd" = (
/mob/living/simple_animal/hostile/syndicate/ranged/infiltrator,
/turf/open/floor/mineral/plastitanium,
/area/awaymission/PactDaivers)
"Sc" = (
/obj/structure/sign/poster/contraband/inteq/inteq_no_sex,
/turf/closed/indestructible/syndicate,
/area/awaymission/PactDaivers)
"SA" = (
/obj/structure/mopbucket,
/obj/item/mop,
/turf/open/floor/plasteel/showroomfloor,
/area/awaymission/PactDaivers)
"Ta" = (
/obj/structure/lattice,
/turf/closed/indestructible/fakeglass,
/area/awaymission/PactDaivers)
"Ug" = (
/obj/effect/decal/cleanable/dirt,
/turf/open/floor/carpet/royalblack,
/area/awaymission/PactDaivers)
"Uh" = (
/obj/machinery/door/airlock/centcom{
	name = "Raiders Barracks";
	req_access_txt = "152"
	},
/obj/effect/turf_decal/siding/wood{
	dir = 1
	},
/turf/open/floor/wood,
/area/awaymission/PactDaivers)
"UT" = (
/obj/structure/table,
/obj/machinery/light/small{
	brightness = 3;
	dir = 8
	},
/obj/structure/bedsheetbin,
/turf/open/floor/plasteel/showroomfloor,
/area/awaymission/PactDaivers)
"VJ" = (
/obj/effect/decal/cleanable/dirt,
/obj/machinery/computer{
	dir = 8
	},
/turf/open/floor/mineral/plastitanium,
/area/awaymission/PactDaivers)
"Wd" = (
/obj/structure/lattice,
/turf/closed/indestructible/syndicate,
/area/awaymission/PactDaivers)
"Yc" = (
/obj/item/storage/firstaid/tactical/nukeop,
/turf/open/floor/mineral/plastitanium,
/area/awaymission/PactDaivers)
"Zi" = (
/obj/structure/closet/crate/bin,
/obj/effect/turf_decal/tile/dark_blue/fourcorners,
/turf/open/floor/plasteel/dark,
/area/awaymission/PactDaivers)
"Zn" = (
/obj/effect/turf_decal/tile/brown/opposingcorners,
/turf/open/floor/plasteel/dark,
/area/awaymission/PactDaivers)
"ZP" = (
/turf/open/indestructible/ironsand,
/area/awaymission/PactDaivers)
"ZW" = (
/obj/machinery/door/airlock/hatch,
/turf/open/space/basic,
/area/awaymission/PactDaivers)

(1,1,1) = {"
ZP
ZP
ZP
ZP
ZP
ZP
ZP
ZP
ZP
ZP
ZP
ZP
ZP
ZP
ZP
ZP
ZP
ZP
ZP
ZP
ZP
ZP
ZP
ZP
ZP
ZP
ZP
ZP
ZP
ZP
ZP
ZP
ZP
ZP
ZP
ZP
ZP
ZP
ZP
ZP
"}
(2,1,1) = {"
ZP
ZP
ZP
ZP
ZP
ZP
ZP
ZP
ZP
ZP
ZP
ZP
ZP
ZP
ZP
ZP
ZP
ZP
ZP
ZP
ZP
ZP
ZP
ZP
ZP
ZP
ZP
ZP
ZP
ZP
ZP
ZP
ZP
ZP
ZP
ZP
ZP
ZP
ZP
ZP
"}
(3,1,1) = {"
ZP
ZP
ZP
ZP
ZP
ZP
ZP
ZP
ZP
ZP
ZP
ZP
ZP
ZP
ZP
ZP
ZP
ZP
ZP
ZP
ZP
ZP
ZP
ZP
ZP
ZP
ZP
ZP
ZP
ZP
ZP
ZP
ZP
ZP
ZP
ZP
ZP
ZP
ZP
ZP
"}
(4,1,1) = {"
ZP
ZP
ZP
ZP
ZP
ZP
ZP
ZP
ZP
ZP
ZP
ZP
ZP
ZP
ZP
ZP
ZP
ZP
ZP
ZP
ZP
ZP
ZP
ZP
ZP
ZP
ZP
ZP
ZP
ZP
ZP
ZP
ZP
ZP
ZP
ZP
ZP
ZP
ZP
ZP
"}
(5,1,1) = {"
ZP
ZP
ZP
ZP
ZP
ZP
ZP
ZP
ZP
ZP
ZP
ZP
ZP
ZP
ZP
ZP
ZP
ZP
ZP
ZP
ZP
ZP
ZP
ZP
ZP
ZP
ZP
ZP
ZP
ZP
ZP
ZP
ZP
ZP
ZP
ZP
ZP
ZP
ZP
ZP
"}
(6,1,1) = {"
ZP
ZP
ZP
ZP
ZP
ZP
ZP
ZP
ZP
ZP
ZP
ZP
ZP
ZP
ZP
ZP
ZP
ZP
ZP
ZP
ZP
ZP
ZP
ZP
ZP
ZP
ZP
ZP
ZP
ZP
ZP
ZP
ZP
ZP
ZP
ZP
ZP
ZP
ZP
ZP
"}
(7,1,1) = {"
ZP
ZP
ZP
ZP
ZP
ZP
ZP
ZP
ZP
ZP
ZP
ZP
ZP
ZP
ZP
ZP
ZP
ZP
ZP
ZP
ZP
ZP
ZP
ZP
ZP
ZP
uC
ZP
ZP
ZP
ZP
ZP
ZP
ZP
ZP
ZP
ZP
ZP
ZP
ZP
"}
(8,1,1) = {"
ZP
ZP
ZP
ZP
ZP
ZP
ZP
ZP
ZP
ZP
ZP
ZP
ZP
ZP
ZP
ZP
ZP
ZP
ZP
ZP
ZP
ZP
ZP
ZP
ZP
ZP
ZP
ZP
ZP
ZP
ZP
ZP
ZP
ZP
ZP
ZP
ZP
ZP
ZP
ZP
"}
(9,1,1) = {"
ZP
ZP
ZP
ZP
ZP
ZP
ZP
ZP
ZP
ZP
ZP
ZP
ZP
ZP
ZP
ZP
ZP
ZP
ZP
ZP
ZP
ZP
ZP
ZP
ZP
ZP
ZP
ZP
ZP
ZP
ZP
ZP
ZP
ZP
ZP
ZP
ZP
ZP
ZP
ZP
"}
(10,1,1) = {"
ZP
ZP
ZP
ZP
ZP
ZP
ZP
ZP
ZP
ZP
ZP
ZP
ZP
ZP
ZP
ZP
ZP
ZP
ZP
ZP
ZP
ZP
ZP
ZP
ZP
ZP
ZP
ZP
ZP
ZP
ZP
ZP
ZP
ZP
ZP
ZP
ZP
ZP
ZP
ZP
"}
(11,1,1) = {"
ZP
ZP
ZP
ZP
ZP
ZP
ZP
ZP
ZP
ZP
ZP
ZP
ZP
ZP
ZP
ZP
ZP
ZP
ZP
ZP
ZP
ZP
ZP
ZP
ZP
ZP
ZP
ZP
ZP
ZP
ZP
ZP
ZP
ZP
ZP
ZP
ZP
ZP
ZP
ZP
"}
(12,1,1) = {"
ZP
ZP
ZP
ZP
ZP
ZP
ZP
ZP
ZP
ZP
ZP
ZP
ZP
ZP
ZP
ZP
ZP
ZP
ZP
ZP
ZP
ZP
ZP
ZP
ZP
ZP
ZP
ZP
ZP
ZP
ZP
ZP
ZP
ZP
ZP
ZP
ZP
ZP
ZP
ZP
"}
(13,1,1) = {"
ZP
ZP
ZP
ZP
ZP
ZP
qX
Nl
Nl
Nl
Nl
qX
Nl
Nl
Nl
qX
Nl
Nl
Nl
qX
Nl
Nl
Nl
Nl
qX
aj
aj
aj
ZP
ZP
aj
aj
aj
aj
ZP
ZP
ZP
ZP
ZP
ZP
"}
(14,1,1) = {"
ZP
ZP
ZP
ig
ZP
Ld
qX
PK
PK
PK
pY
PK
PK
PK
pY
PK
PK
PK
pY
PK
PK
PK
pY
PK
qX
ZP
uC
ZP
ZP
ZP
ZP
ZP
ZP
aj
ZP
ZP
ZP
ZP
ZP
ZP
"}
(15,1,1) = {"
ZP
ZP
ZP
ZP
uC
ZP
qX
PK
PK
PK
PK
PK
PK
PK
PK
PK
PK
PK
PK
PK
PK
PK
PK
PK
qX
ZP
ZP
ZP
ZP
ZP
ZP
uC
ZP
aj
ZP
ZP
ZP
ZP
ZP
ZP
"}
(16,1,1) = {"
ZP
ZP
ZP
ZP
ZP
ZP
qX
PK
PK
PK
PK
PK
PK
PK
PK
PK
PK
PK
PK
PK
PK
PK
PK
PK
qX
ZP
ZP
ZP
uC
ZP
ZP
ZP
ZP
aj
ZP
ZP
ZP
ZP
ZP
ZP
"}
(17,1,1) = {"
ZP
ZP
ZP
ZP
ZP
ZP
qX
PK
PK
PK
PK
PK
PK
PK
PK
PK
PK
PK
PK
PK
PK
PK
PK
PK
qX
ZP
ZP
ZP
ZP
ZP
ZP
ZP
ZP
aj
ZP
ZP
ZP
ZP
ZP
ZP
"}
(18,1,1) = {"
ZP
ZP
ZP
ZP
ZP
ZP
qX
PK
PK
PK
PK
PK
PK
PK
PK
PK
PK
PK
PK
PK
PK
PK
PK
PK
qX
qX
qX
qX
qX
qX
qX
qX
qX
qX
ZP
ZP
ZP
ZP
ZP
ZP
"}
(19,1,1) = {"
ZP
ZP
ZP
li
li
li
qX
qX
ZW
qX
qX
qX
qX
ZW
qX
qX
qX
ZW
qX
qX
qX
qX
ZW
qX
qX
Sc
QZ
eb
pN
vj
pa
hn
zM
qX
ZP
ZP
ZP
ZP
ZP
ZP
"}
(20,1,1) = {"
ZP
ZP
ZP
li
PK
PK
li
Zn
Zn
Zn
Qd
JR
Qd
Zn
Zn
Zn
Zn
Zn
Qd
OH
Bi
Qd
Zn
Zn
Zn
qX
Zn
Ab
Zn
Zn
Uh
gd
gd
dp
ZP
ZP
ZP
ZP
ZP
ZP
"}
(21,1,1) = {"
ZP
ZP
ZP
vx
PK
PK
yR
Zn
Zn
Ab
Zn
Zn
Zn
Zn
Zn
Zn
Zn
Zn
Zn
Zn
Zn
Zn
Zn
Zn
Zn
aD
FN
Zn
Zn
qj
qX
Ni
Ni
Wd
ZP
ZP
ZP
ZP
ZP
ZP
"}
(22,1,1) = {"
ZP
ZP
ZP
li
PK
PK
li
Zn
Zn
Zn
Zn
Zn
Zn
Zn
Zn
Zn
Zn
Zn
Zn
Ab
Zn
Zn
Zn
Zn
Zn
qX
Zn
qX
nP
Sc
qX
Ta
Ta
qX
ZP
ZP
ZP
ZP
ZP
ZP
"}
(23,1,1) = {"
ZP
ZP
ZP
li
li
li
qX
qX
qX
qX
qX
qX
qX
qX
qX
Ox
qX
qX
qX
qX
Cv
qX
LG
qX
qX
Sc
Hj
qX
gd
ml
qX
ZP
ZP
ZP
ZP
ZP
ZP
ZP
ZP
ZP
"}
(24,1,1) = {"
ZP
ZP
ZP
ZP
ZP
ZP
ZP
qX
qX
qX
qX
qX
qX
qX
ho
ho
ho
qX
qX
qX
qX
sb
ih
nb
qX
qX
Zn
qX
Mk
yE
qX
ZP
ZP
ZP
ZP
ZP
ZP
ZP
ZP
ZP
"}
(25,1,1) = {"
ZP
ZP
ZP
ZP
ZP
ZP
ZP
ZP
qX
qX
qX
qX
rx
Yc
fe
Rd
ho
fe
ve
qX
Cv
Ll
ih
Ug
Cv
qX
vG
qX
qX
qX
qX
qX
ZP
ZP
ZP
ZP
ZP
ZP
ZP
ZP
"}
(26,1,1) = {"
ZP
ZP
ZP
ZP
ZP
ZP
ZP
ZP
ZP
qX
qX
qX
Cf
fe
ho
Da
ho
fe
dg
qX
qX
ph
ih
tD
qX
Ds
Qe
vG
GC
UT
HI
Wd
ZP
ZP
ZP
ZP
ZP
ZP
ZP
ZP
"}
(27,1,1) = {"
ZP
ZP
ZP
ZP
ZP
ZP
ZP
ZP
ZP
ZP
qX
qX
Cf
Fq
FU
VJ
vv
ho
ve
qX
qX
qX
qX
qX
qX
bA
Qe
qX
Ci
BW
BW
qX
ZP
ZP
ig
ZP
ZP
ZP
ZP
ZP
"}
(28,1,1) = {"
ZP
ZP
ZP
ZP
ZP
ZP
ZP
ZP
ig
ZP
ZP
pa
Cf
Bc
xW
mM
xW
Jf
ve
pa
qX
qX
qX
qX
qX
qX
Zi
qX
JS
gv
SA
Wd
ZP
ZP
ZP
ZP
ZP
ZP
ZP
ZP
"}
(29,1,1) = {"
ZP
ZP
ZP
ZP
ZP
ZP
ZP
ZP
ZP
ZP
ZP
qX
qX
qX
ho
ho
ho
qX
qX
qX
ZP
ZP
ZP
ZP
qX
qX
qX
qX
qX
qX
qX
qX
ZP
ZP
ZP
ZP
ZP
ZP
ZP
ZP
"}
(30,1,1) = {"
ZP
ZP
ZP
ZP
ZP
ZP
ZP
ZP
ZP
ZP
ZP
ZP
ZP
li
jd
ho
jd
li
ZP
ZP
ZP
ZP
ZP
ZP
ZP
ZP
ZP
ZP
ZP
ZP
ZP
ZP
ZP
ZP
ZP
ZP
ZP
ZP
ZP
ZP
"}
(31,1,1) = {"
ZP
ZP
ZP
ZP
ZP
ZP
ZP
ZP
uC
ZP
ZP
ZP
ZP
li
li
li
li
li
ZP
ZP
ZP
ZP
ig
ZP
ZP
ZP
ZP
ZP
ZP
ZP
ZP
ZP
ZP
ZP
ZP
ZP
ZP
ZP
ZP
ZP
"}
(32,1,1) = {"
ZP
ZP
ZP
ZP
ZP
ZP
ZP
ZP
ZP
ZP
ZP
ZP
ZP
ZP
ZP
ZP
ZP
ZP
ZP
ZP
ZP
ZP
ZP
ZP
ZP
ZP
ZP
ZP
ZP
ZP
ZP
ZP
ZP
ZP
ZP
ZP
ZP
ZP
ZP
ZP
"}
(33,1,1) = {"
ZP
ZP
ZP
ZP
ZP
ZP
ZP
ZP
ZP
ZP
ZP
ZP
ZP
ZP
ZP
ZP
ZP
ZP
ZP
ZP
ZP
ZP
ZP
ZP
ZP
ZP
uC
ZP
ZP
ZP
ZP
ZP
ZP
ZP
ZP
ZP
ZP
ZP
ZP
ZP
"}
(34,1,1) = {"
ZP
ZP
ZP
ZP
ZP
ZP
ZP
ZP
ZP
ZP
ZP
ZP
ZP
ZP
ZP
ZP
ZP
ZP
ZP
ZP
ZP
ZP
ZP
ZP
ZP
ZP
ZP
ZP
ZP
ZP
ZP
ZP
ZP
ZP
ZP
ZP
ZP
ZP
ZP
ZP
"}
(35,1,1) = {"
ZP
ZP
ZP
ZP
ZP
ZP
ZP
ZP
ZP
ZP
ZP
ZP
ZP
ZP
ZP
ZP
ZP
ZP
ZP
ZP
ZP
ZP
ZP
ZP
ZP
ZP
ZP
ZP
ZP
ZP
ZP
ZP
ZP
ZP
ZP
ZP
ZP
ZP
ZP
ZP
"}
(36,1,1) = {"
ZP
ZP
ZP
ZP
ZP
ZP
ZP
ZP
ZP
ZP
ZP
ZP
ZP
ZP
ZP
ZP
ZP
ZP
ZP
ZP
ZP
ZP
ZP
ZP
ZP
ZP
ZP
ZP
ZP
ZP
ZP
ZP
ZP
ZP
ZP
ZP
ZP
ZP
ZP
ZP
"}
(37,1,1) = {"
ZP
ZP
ZP
ZP
ZP
ZP
ZP
ZP
ZP
ZP
ZP
ZP
ZP
ZP
ZP
ZP
ZP
ZP
ZP
ZP
ZP
ZP
ZP
ZP
ZP
ZP
ZP
ZP
ZP
ZP
ZP
ZP
ZP
ZP
ZP
ZP
ZP
ZP
ZP
ZP
"}
(38,1,1) = {"
ZP
ZP
ZP
ZP
ZP
ZP
ZP
ZP
ZP
ZP
ZP
ZP
ZP
ZP
ZP
ZP
ZP
ZP
ZP
ZP
ZP
ZP
ZP
ZP
ZP
ZP
ZP
ZP
ZP
ZP
ZP
ZP
ZP
ZP
ZP
ZP
ZP
ZP
ZP
ZP
"}
(39,1,1) = {"
ZP
ZP
ZP
ZP
ZP
ZP
ZP
ZP
ZP
ZP
ZP
ZP
ZP
ZP
ZP
ZP
ZP
ZP
ZP
ZP
ZP
ZP
ZP
ZP
ZP
ZP
ZP
ZP
ZP
ZP
ZP
ZP
ZP
ZP
ZP
ZP
ZP
ZP
ZP
ZP
"}
(40,1,1) = {"
ZP
ZP
ZP
ZP
ZP
ZP
ZP
ZP
ZP
ZP
ZP
ZP
ZP
ZP
ZP
ZP
ZP
ZP
ZP
ZP
ZP
ZP
ZP
ZP
ZP
ZP
ZP
ZP
ZP
ZP
ZP
ZP
ZP
ZP
ZP
ZP
ZP
ZP
ZP
ZP
"}
