//MAP CONVERTED BY dmm2tgm.py THIS HEADER COMMENT PREVENTS RECONVERSION, DO NOT REMOVE
"a" = (
/turf/closed/wall/r_wall/syndicate,
/area/awaymission/PactDaivers)
"b" = (
/obj/structure/sign/flag/inteq{
	pixel_x = 32;
	pixel_y = 27
	},
/obj/structure/closet/secure_closet{
	anchored = 1;
	icon = 'icons/obj/closet.dmi';
	icon_state = "riot";
	name = "armory munitions locker";
	req_access_txt = "151"
	},
/obj/item/gun/ballistic/automatic/hellgate_sg60,
/obj/item/ammo_box/magazine/hellgate_sg60,
/obj/item/ammo_box/magazine/hellgate_sg60,
/obj/item/ammo_box/magazine/hellgate_sg60,
/turf/open/floor/carpet/royalblack,
/area/awaymission/PactDaivers)
"c" = (
/obj/structure/bed,
/obj/item/bedsheet/inteq,
/obj/effect/mob_spawn/human/inteqspace/PactDaivers,
/turf/open/floor/carpet/royalblack,
/area/awaymission/PactDaivers)
"h" = (
/obj/effect/mob_spawn/human/corpse/russian,
/turf/open/indestructible/ironsand,
/area/awaymission/PactDaivers)
"j" = (
/obj/machinery/power/floodlight/lamppost/four,
/turf/open/indestructible/ironsand,
/area/awaymission/PactDaivers)
"l" = (
/obj/structure/table/wood,
/obj/machinery/computer/med_data/laptop{
	dir = 1
	},
/turf/open/floor/wood,
/area/awaymission/PactDaivers)
"q" = (
/turf/open/indestructible/ironsand,
/area/awaymission/PactDaivers)
"y" = (
/obj/item/export/bottle/vodka,
/turf/open/indestructible/ironsand,
/area/awaymission/PactDaivers)
"B" = (
/obj/structure/closet/syndicate/inteq,
/obj/machinery/light/small,
/obj/item/bikehorn/rubberducky,
/turf/open/floor/carpet/royalblack,
/area/awaymission/PactDaivers)
"E" = (
/obj/effect/mob_spawn/human/corpse/russian,
/obj/item/export/bottle/vodka,
/turf/open/indestructible/ironsand,
/area/awaymission/PactDaivers)
"G" = (
/obj/effect/decal/cleanable/dirt,
/turf/open/floor/carpet/royalblack,
/area/awaymission/PactDaivers)
"L" = (
/mob/living/simple_animal/hostile/syndicate/ranged/shotgun,
/turf/open/indestructible/ironsand,
/area/awaymission/PactDaivers)
"P" = (
/obj/structure/hellgate_vehicle,
/turf/open/indestructible/ironsand,
/area/awaymission/PactDaivers)
"U" = (
/obj/structure/reagent_dispensers/beerkeg,
/obj/structure/reagent_dispensers/beerkeg{
	pixel_y = 14
	},
/turf/open/indestructible/ironsand,
/area/awaymission/PactDaivers)
"V" = (
/obj/machinery/door/airlock/centcom{
	name = "Raiders Barracks";
	req_access_txt = "152"
	},
/turf/open/floor/carpet/royalblack,
/area/awaymission/PactDaivers)
"Y" = (
/turf/open/floor/carpet/royalblack,
/area/awaymission/PactDaivers)
"Z" = (
/obj/effect/decal/cleanable/dirt,
/obj/structure/rack{
	dir = 8
	},
/obj/item/gun/medbeam,
/turf/open/floor/carpet/royalblack,
/area/awaymission/PactDaivers)

(1,1,1) = {"
q
q
q
q
q
q
q
q
q
q
q
q
q
q
q
q
q
q
q
q
"}
(2,1,1) = {"
q
q
q
q
q
q
q
q
q
q
q
q
q
q
q
q
q
q
q
q
"}
(3,1,1) = {"
q
q
q
q
q
q
q
q
q
q
q
q
q
q
q
q
q
q
q
q
"}
(4,1,1) = {"
q
q
q
q
q
q
q
q
q
q
q
q
q
q
q
q
q
q
q
q
"}
(5,1,1) = {"
q
q
q
q
q
q
q
q
q
q
q
q
q
q
q
q
q
q
q
q
"}
(6,1,1) = {"
q
q
q
q
q
q
q
q
q
q
q
q
q
q
q
q
q
q
q
q
"}
(7,1,1) = {"
q
q
q
q
q
q
q
y
E
q
L
q
q
q
q
q
q
q
q
q
"}
(8,1,1) = {"
q
q
q
q
q
q
y
y
y
y
h
q
q
q
q
q
q
q
q
q
"}
(9,1,1) = {"
q
q
q
q
q
q
y
q
q
P
q
q
q
q
q
q
q
q
q
q
"}
(10,1,1) = {"
q
q
q
q
q
q
q
q
q
q
a
a
j
q
q
a
a
q
q
q
"}
(11,1,1) = {"
q
q
q
q
q
q
q
U
E
h
a
a
a
V
a
a
a
q
q
q
"}
(12,1,1) = {"
q
q
q
q
q
q
q
q
q
q
q
a
b
Y
l
a
q
q
q
q
"}
(13,1,1) = {"
q
q
q
q
q
q
q
q
q
L
j
a
B
Y
G
a
j
q
q
q
"}
(14,1,1) = {"
q
q
q
q
q
q
q
q
q
q
q
a
c
Y
Z
a
q
q
q
q
"}
(15,1,1) = {"
q
q
q
q
q
q
q
q
q
q
a
a
a
a
a
a
a
q
q
q
"}
(16,1,1) = {"
q
q
q
q
q
q
q
q
q
q
a
a
q
j
q
a
a
q
q
q
"}
(17,1,1) = {"
q
q
q
q
q
q
q
q
q
q
q
q
q
q
q
q
q
q
q
q
"}
(18,1,1) = {"
q
q
q
q
q
q
q
q
q
q
q
q
q
q
q
q
q
q
q
q
"}
(19,1,1) = {"
q
q
q
q
q
q
q
q
q
q
q
q
q
q
q
q
q
q
q
q
"}
(20,1,1) = {"
q
q
q
q
q
q
q
q
q
q
q
q
q
q
q
q
q
q
q
q
"}
