//MAP CONVERTED BY dmm2tgm.py THIS HEADER COMMENT PREVENTS RECONVERSION, DO NOT REMOVE
"a" = (
/turf/open/indestructible/ironsand,
/area/awaymission/PactDaivers)
"g" = (
/obj/structure/mecha_wreckage/hermes,
/turf/open/indestructible/ironsand,
/area/awaymission/PactDaivers)
"i" = (
/mob/living/simple_animal/hostile/syndicate/mecha_pilot/inteq,
/turf/open/indestructible/ironsand,
/area/awaymission/PactDaivers)
"l" = (
/mob/living/simple_animal/hostile/nanotrasen/ranged/assault,
/turf/open/indestructible/ironsand,
/area/awaymission/PactDaivers)
"m" = (
/mob/living/simple_animal/hostile/syndicate/mecha_pilot/inteq/light,
/turf/open/indestructible/ironsand,
/area/awaymission/PactDaivers)
"p" = (
/obj/structure/mecha_wreckage/durand/neovgre,
/turf/open/indestructible/ironsand,
/area/awaymission/PactDaivers)
"A" = (
/mob/living/simple_animal/hostile/syndicate/mecha_pilot/no_mech/nanotrasen,
/turf/open/indestructible/ironsand,
/area/awaymission/PactDaivers)
"M" = (
/mob/living/simple_animal/hostile/nanotrasen/ranged,
/turf/open/indestructible/ironsand,
/area/awaymission/PactDaivers)
"R" = (
/mob/living/simple_animal/hostile/syndicate/space/stormtrooper,
/turf/open/indestructible/ironsand,
/area/awaymission/PactDaivers)
"Z" = (
/obj/structure/mecha_wreckage/gygax,
/turf/open/indestructible/ironsand,
/area/awaymission/PactDaivers)

(1,1,1) = {"
a
a
a
a
a
a
a
a
a
a
a
a
a
a
a
a
a
a
a
a
"}
(2,1,1) = {"
a
a
a
a
a
a
a
a
a
a
a
a
a
a
a
a
a
a
a
a
"}
(3,1,1) = {"
a
a
a
a
a
a
a
a
a
a
a
a
a
A
Z
a
a
a
a
a
"}
(4,1,1) = {"
a
a
a
a
a
a
Z
a
a
M
a
a
a
a
a
a
a
a
a
a
"}
(5,1,1) = {"
a
a
a
a
a
a
a
a
a
a
a
a
R
a
a
a
a
a
a
a
"}
(6,1,1) = {"
a
a
a
a
a
a
A
a
a
a
a
a
a
a
a
a
a
a
a
a
"}
(7,1,1) = {"
a
a
a
a
l
a
a
a
a
a
a
a
a
a
a
a
a
a
a
a
"}
(8,1,1) = {"
a
a
a
a
a
a
a
a
a
a
a
a
a
a
a
a
a
a
a
a
"}
(9,1,1) = {"
a
a
a
a
a
a
a
a
a
a
A
a
a
a
a
a
a
a
a
a
"}
(10,1,1) = {"
a
a
a
a
a
a
a
M
a
p
a
a
a
a
a
g
a
a
a
a
"}
(11,1,1) = {"
a
a
a
a
a
a
a
a
a
a
a
a
a
a
a
a
a
a
a
a
"}
(12,1,1) = {"
a
a
a
a
a
a
a
a
a
a
a
a
a
a
a
a
a
a
a
a
"}
(13,1,1) = {"
a
a
a
a
a
a
a
a
a
a
a
a
a
a
a
a
a
a
l
a
"}
(14,1,1) = {"
a
a
a
l
a
m
a
a
l
a
a
a
l
a
a
a
a
a
a
a
"}
(15,1,1) = {"
a
a
a
a
a
a
a
a
a
a
a
a
a
a
a
a
a
a
a
a
"}
(16,1,1) = {"
a
a
a
a
a
a
a
a
a
a
a
a
a
a
a
a
g
a
a
a
"}
(17,1,1) = {"
a
a
a
a
a
a
a
a
a
a
a
a
a
a
a
a
a
a
a
a
"}
(18,1,1) = {"
a
a
a
a
a
a
a
a
a
a
a
a
a
a
a
a
a
a
a
a
"}
(19,1,1) = {"
a
a
a
a
a
a
l
a
a
a
i
a
a
a
a
a
a
a
a
a
"}
(20,1,1) = {"
a
a
a
a
a
a
a
a
a
a
a
a
a
a
a
a
a
a
a
a
"}
