//MAP CONVERTED BY dmm2tgm.py THIS HEADER COMMENT PREVENTS RECONVERSION, DO NOT REMOVE
"a" = (
/turf/open/indestructible/ironsand,
/area/awaymission/PactDaivers)
"b" = (
/turf/open/floor/plating/ironsand,
/area/awaymission/PactDaivers)
"c" = (
/obj/effect/temp_visual/fire,
/turf/open/indestructible/ironsand,
/area/awaymission/PactDaivers)
"h" = (
/turf/open/floor/plating/ironsand{
	icon_state = "ironsand9"
	},
/area/awaymission/PactDaivers)
"j" = (
/obj/item/ammo_box/magazine/hellgate_vp78,
/obj/item/ammo_box/magazine/hellgate_vp78,
/obj/item/ammo_box/magazine/hellgate_vp78,
/obj/item/gun/ballistic/automatic/pistol/hellgate_vp78,
/obj/item/ammo_box/c10mm,
/obj/item/ammo_box/c10mm,
/obj/item/ammo_box/c10mm,
/obj/item/ammo_box/c10mm,
/obj/item/ammo_box/c10mm,
/obj/item/ammo_box/c10mm,
/obj/structure/urbanismbigcrate/alt,
/obj/effect/turf_decal/weather/sand/plating,
/obj/structure/lattice/catwalk,
/obj/item/reagent_containers/hypospray/medipen/stimpack/traitor,
/turf/open/indestructible/ironsand,
/area/awaymission/PactDaivers)
"k" = (
/turf/open/floor/plating/ironsand{
	pixel_x = 0;
	pixel_y = 0
	},
/area/awaymission/PactDaivers)
"x" = (
/obj/structure/hellgate_dropship,
/turf/open/indestructible/ironsand,
/area/awaymission/PactDaivers)
"E" = (
/turf/open/floor/plating/ironsand{
	icon_state = "ironsand2"
	},
/area/awaymission/PactDaivers)
"S" = (
/obj/item/ammo_box/magazine/hellgate_vp78,
/obj/item/ammo_box/magazine/hellgate_vp78,
/obj/item/ammo_box/magazine/hellgate_vp78,
/obj/item/gun/ballistic/automatic/pistol/hellgate_vp78,
/obj/item/ammo_box/c10mm,
/obj/item/ammo_box/c10mm,
/obj/item/ammo_box/c10mm,
/obj/item/ammo_box/c10mm,
/obj/item/ammo_box/c10mm,
/obj/item/ammo_box/c10mm,
/obj/structure/urbanismbigcrate/alt,
/obj/effect/turf_decal/weather/sand/plating,
/obj/structure/lattice/catwalk,
/obj/item/reagent_containers/hypospray/medipen/stimpack/traitor,
/turf/open/floor/plating/ironsand{
	icon_state = "ironsand2"
	},
/area/awaymission/PactDaivers)
"T" = (
/obj/structure/hellgate_dropship/sad,
/turf/open/indestructible/ironsand,
/area/awaymission/PactDaivers)
"U" = (
/obj/effect/landmark/awaystart,
/obj/effect/turf_decal/weather/sand/plating,
/turf/open/indestructible/ironsand,
/area/awaymission/PactDaivers)

(1,1,1) = {"
a
a
a
a
a
a
a
a
a
a
a
a
a
a
a
a
a
a
a
a
"}
(2,1,1) = {"
a
a
a
a
E
a
a
a
a
a
a
a
a
a
a
a
a
a
a
a
"}
(3,1,1) = {"
a
a
a
a
E
a
a
a
a
a
a
a
a
a
a
a
a
T
a
a
"}
(4,1,1) = {"
a
a
a
a
a
a
E
a
a
a
a
h
a
a
c
a
a
a
a
a
"}
(5,1,1) = {"
a
a
a
a
a
a
k
a
a
a
a
a
a
a
a
c
a
a
a
a
"}
(6,1,1) = {"
a
a
a
a
a
a
U
a
a
k
a
a
a
a
a
a
a
a
a
a
"}
(7,1,1) = {"
a
a
h
a
a
a
S
a
a
a
a
a
a
a
a
a
a
a
a
a
"}
(8,1,1) = {"
a
a
a
a
a
a
a
a
a
h
a
k
a
E
a
a
a
a
a
a
"}
(9,1,1) = {"
a
a
a
a
a
a
a
a
a
a
a
a
a
a
j
a
a
U
a
a
"}
(10,1,1) = {"
a
a
a
a
a
a
a
a
a
a
k
k
k
a
a
a
h
h
a
a
"}
(11,1,1) = {"
a
a
E
a
a
a
h
k
a
h
a
a
a
a
a
a
a
a
a
a
"}
(12,1,1) = {"
a
a
a
a
a
a
a
a
a
k
b
a
a
a
a
a
a
a
a
a
"}
(13,1,1) = {"
a
a
a
a
a
a
a
a
a
E
a
a
a
a
a
a
a
a
a
a
"}
(14,1,1) = {"
a
a
a
a
a
a
a
a
a
a
a
a
a
a
k
k
E
a
a
a
"}
(15,1,1) = {"
a
a
a
a
a
a
E
x
a
a
a
a
j
a
a
a
a
a
a
a
"}
(16,1,1) = {"
a
c
a
a
a
a
a
a
a
h
a
a
a
U
a
a
a
k
a
a
"}
(17,1,1) = {"
a
a
a
a
c
a
a
a
a
a
a
a
a
h
a
a
a
a
a
a
"}
(18,1,1) = {"
a
a
a
a
a
a
a
a
a
a
a
a
a
E
a
a
a
a
a
a
"}
(19,1,1) = {"
a
a
a
a
a
a
a
E
a
a
a
a
a
a
a
a
a
a
a
a
"}
(20,1,1) = {"
a
a
a
a
a
a
a
a
a
a
a
a
a
a
a
a
a
a
a
a
"}
