//MAP CONVERTED BY dmm2tgm.py THIS HEADER COMMENT PREVENTS RECONVERSION, DO NOT REMOVE
"a" = (
/turf/open/indestructible/ironsand,
/area/awaymission/PactDaivers)
"b" = (
/turf/open/floor/pod{
	initial_gas_mix = "o2=14;n2=23;TEMP=300"
	},
/area/awaymission/PactDaivers)
"e" = (
/mob/living/simple_animal/hostile/syndicate/ranged/smg/space,
/turf/open/indestructible/ironsand,
/area/awaymission/PactDaivers)
"j" = (
/obj/effect/mob_spawn/human/inteqspace/PactDaivers,
/turf/open/floor/pod{
	initial_gas_mix = "o2=14;n2=23;TEMP=300"
	},
/area/awaymission/PactDaivers)
"B" = (
/turf/closed/mineral/ash_rock,
/area/awaymission/PactDaivers)
"D" = (
/obj/item/gun/ballistic/automatic/hellgate_c77,
/obj/item/ammo_box/magazine/hellgate_c77,
/obj/item/ammo_box/magazine/hellgate_c77,
/obj/structure/closet/crate,
/turf/open/floor/pod{
	initial_gas_mix = "o2=14;n2=23;TEMP=300"
	},
/area/awaymission/PactDaivers)
"E" = (
/obj/structure/oldtrap/razor_wire/industrial,
/turf/open/indestructible/ironsand,
/area/awaymission/PactDaivers)
"F" = (
/obj/structure/barricade/sandbags,
/turf/open/indestructible/ironsand,
/area/awaymission/PactDaivers)
"G" = (
/mob/living/simple_animal/hostile/syndicate/civilian,
/turf/open/indestructible/ironsand,
/area/awaymission/PactDaivers)
"K" = (
/obj/structure/oldtrap/razor_wire/industrial,
/obj/structure/oldtrap/razor_wire/industrial,
/turf/open/indestructible/ironsand,
/area/awaymission/PactDaivers)
"L" = (
/obj/structure/hellgate_campaign,
/turf/open/indestructible/ironsand,
/area/awaymission/PactDaivers)
"P" = (
/mob/living/simple_animal/hostile/syndicate/civilian,
/turf/open/floor/pod{
	initial_gas_mix = "o2=14;n2=23;TEMP=300"
	},
/area/awaymission/PactDaivers)
"Q" = (
/obj/structure/hellgate_beacon/deployed{
	pixel_y = -1;
	pixel_x = -9;
	name = "Сенсорный датчик"
	},
/turf/open/floor/pod{
	initial_gas_mix = "o2=14;n2=23;TEMP=300"
	},
/area/awaymission/PactDaivers)

(1,1,1) = {"
a
a
a
a
a
a
a
a
a
a
a
a
a
a
a
a
a
a
a
a
a
a
a
a
a
a
a
a
a
a
a
a
a
a
a
a
a
a
a
a
"}
(2,1,1) = {"
a
a
a
a
a
a
a
a
a
a
a
a
a
a
a
a
a
a
a
a
a
a
a
a
a
a
a
a
a
a
a
a
a
a
a
a
a
a
a
a
"}
(3,1,1) = {"
a
a
a
a
a
E
E
E
a
a
a
a
a
a
a
a
a
a
a
a
E
E
E
E
a
a
a
a
a
a
a
a
a
a
a
a
a
a
a
a
"}
(4,1,1) = {"
a
a
a
a
E
E
F
E
E
a
a
a
a
a
a
a
a
a
a
a
E
F
F
F
E
a
a
a
a
a
a
a
a
a
a
a
a
a
a
a
"}
(5,1,1) = {"
a
a
a
a
E
F
F
F
F
a
a
a
a
a
a
a
a
a
a
a
F
F
a
F
F
a
a
a
F
E
a
a
a
a
a
a
a
a
a
a
"}
(6,1,1) = {"
a
a
a
a
F
F
a
a
a
a
a
a
a
a
a
a
a
a
a
a
a
a
a
a
a
a
a
a
F
E
E
a
a
a
a
a
a
a
a
a
"}
(7,1,1) = {"
a
a
a
a
a
a
a
a
a
a
a
a
e
a
a
a
a
a
a
a
a
a
a
a
a
a
a
a
a
F
E
a
a
a
a
a
a
a
a
a
"}
(8,1,1) = {"
a
a
a
a
a
a
a
a
a
a
a
a
a
a
a
a
a
e
a
a
a
a
a
a
a
a
a
a
a
a
F
E
a
a
a
a
a
a
a
a
"}
(9,1,1) = {"
a
a
a
a
a
a
a
a
a
a
a
a
a
a
a
a
a
a
a
a
a
a
a
a
a
a
a
a
a
a
F
E
a
a
a
a
a
a
a
a
"}
(10,1,1) = {"
a
a
a
a
a
a
a
a
a
a
a
a
a
a
a
a
a
a
a
a
a
a
a
a
a
a
a
a
a
F
E
E
a
a
a
a
a
a
a
a
"}
(11,1,1) = {"
a
a
E
a
a
a
a
a
a
a
a
a
a
b
b
D
a
a
a
a
a
a
a
a
a
a
a
a
a
a
a
a
a
a
a
a
a
a
a
a
"}
(12,1,1) = {"
a
a
E
a
a
a
a
a
a
L
a
a
a
b
Q
b
a
a
a
a
a
a
a
a
a
a
a
a
a
a
a
a
a
a
a
a
a
a
a
a
"}
(13,1,1) = {"
a
a
E
B
B
a
a
a
a
a
G
a
a
j
P
b
a
a
a
a
a
a
a
a
a
a
a
a
a
a
a
a
a
a
a
a
a
a
a
a
"}
(14,1,1) = {"
a
a
E
B
B
B
a
a
a
a
a
a
a
a
a
a
a
a
a
a
a
a
a
a
L
a
a
a
B
B
a
a
a
a
a
a
a
a
a
a
"}
(15,1,1) = {"
a
E
E
a
B
B
a
a
a
a
a
a
a
a
a
a
a
a
a
a
a
a
a
a
a
G
a
B
B
B
B
a
a
a
a
a
a
a
a
a
"}
(16,1,1) = {"
a
E
a
a
a
B
B
a
a
a
a
a
a
a
a
a
a
a
a
a
a
a
a
a
a
a
a
B
B
B
E
a
a
a
a
a
a
a
a
a
"}
(17,1,1) = {"
a
E
a
a
B
B
B
a
a
a
a
a
a
a
a
a
a
a
a
L
a
a
a
a
a
a
B
B
B
a
E
a
a
a
a
a
a
a
a
a
"}
(18,1,1) = {"
a
E
a
a
a
B
B
a
a
a
a
a
a
L
a
a
a
a
a
a
G
a
a
a
a
a
B
B
a
E
a
a
a
a
a
a
a
a
a
a
"}
(19,1,1) = {"
a
E
E
a
a
a
B
B
a
a
a
a
a
a
G
a
a
a
a
a
a
a
a
B
B
B
B
B
E
E
a
a
a
a
a
a
a
a
a
a
"}
(20,1,1) = {"
a
a
E
a
a
B
B
B
a
a
a
a
a
a
a
a
a
a
a
a
a
a
B
B
B
B
B
a
E
E
a
a
a
a
a
a
a
a
a
a
"}
(21,1,1) = {"
a
a
E
E
a
B
B
B
a
a
a
a
a
a
a
a
a
a
a
a
B
B
B
B
B
a
E
E
E
a
a
a
a
a
a
a
a
a
a
a
"}
(22,1,1) = {"
a
a
a
E
a
a
B
B
B
B
a
a
a
a
B
B
B
B
B
B
B
B
B
B
B
E
E
a
a
a
a
a
a
a
a
a
a
a
a
a
"}
(23,1,1) = {"
a
a
a
E
E
a
B
B
B
B
B
B
B
B
B
B
B
B
B
B
B
B
B
a
E
E
a
a
a
a
a
a
a
a
a
a
a
a
a
a
"}
(24,1,1) = {"
a
a
a
a
E
E
a
a
a
B
B
B
B
B
B
B
B
a
a
a
a
a
E
E
E
a
a
a
a
a
a
a
a
a
a
a
a
a
a
a
"}
(25,1,1) = {"
a
a
a
a
a
E
E
E
E
a
a
a
a
a
a
a
a
a
E
E
E
E
E
a
a
a
a
a
a
a
a
a
a
a
a
a
a
a
a
a
"}
(26,1,1) = {"
a
a
a
a
a
a
a
a
a
E
E
K
K
K
K
E
K
E
E
a
a
a
a
a
a
a
a
a
a
a
a
a
a
a
a
a
a
a
a
a
"}
(27,1,1) = {"
a
a
a
a
a
a
a
a
a
a
a
a
a
a
a
a
a
a
a
a
a
a
a
a
a
a
a
a
a
a
a
a
a
a
a
a
a
a
a
a
"}
(28,1,1) = {"
a
a
a
a
a
a
a
a
a
a
a
a
a
a
a
a
a
a
a
a
a
a
a
a
a
a
a
a
a
a
a
a
a
a
a
a
a
a
a
a
"}
(29,1,1) = {"
a
a
a
a
a
a
a
a
a
a
a
a
a
a
a
a
a
a
a
a
a
a
a
a
a
a
a
a
a
a
a
a
a
a
a
a
a
a
a
a
"}
(30,1,1) = {"
a
a
a
a
a
a
a
a
a
a
a
a
a
a
a
a
a
a
a
a
a
a
a
a
a
a
a
a
a
a
a
a
a
a
a
a
a
a
a
a
"}
(31,1,1) = {"
a
a
a
a
a
a
a
a
a
a
a
a
a
a
a
a
a
a
a
a
a
a
a
a
a
a
a
a
a
a
a
a
a
a
a
a
a
a
a
a
"}
(32,1,1) = {"
a
a
a
a
a
a
a
a
a
a
a
a
a
a
a
a
a
a
a
a
a
a
a
a
a
a
a
a
a
a
a
a
a
a
a
a
a
a
a
a
"}
(33,1,1) = {"
a
a
a
a
a
a
a
a
a
a
a
a
a
a
a
a
a
a
a
a
a
a
a
a
a
a
a
a
a
a
a
a
a
a
a
a
a
a
a
a
"}
(34,1,1) = {"
a
a
a
a
a
a
a
a
a
a
a
a
a
a
a
a
a
a
a
a
a
a
a
a
a
a
a
a
a
a
a
a
a
a
a
a
a
a
a
a
"}
(35,1,1) = {"
a
a
a
a
a
a
a
a
a
a
a
a
a
a
a
a
a
a
a
a
a
a
a
a
a
a
a
a
a
a
a
a
a
a
a
a
a
a
a
a
"}
(36,1,1) = {"
a
a
a
a
a
a
a
a
a
a
a
a
a
a
a
a
a
a
a
a
a
a
a
a
a
a
a
a
a
a
a
a
a
a
a
a
a
a
a
a
"}
(37,1,1) = {"
a
a
a
a
a
a
a
a
a
a
a
a
a
a
a
a
a
a
a
a
a
a
a
a
a
a
a
a
a
a
a
a
a
a
a
a
a
a
a
a
"}
(38,1,1) = {"
a
a
a
a
a
a
a
a
a
a
a
a
a
a
a
a
a
a
a
a
a
a
a
a
a
a
a
a
a
a
a
a
a
a
a
a
a
a
a
a
"}
(39,1,1) = {"
a
a
a
a
a
a
a
a
a
a
a
a
a
a
a
a
a
a
a
a
a
a
a
a
a
a
a
a
a
a
a
a
a
a
a
a
a
a
a
a
"}
(40,1,1) = {"
a
a
a
a
a
a
a
a
a
a
a
a
a
a
a
a
a
a
a
a
a
a
a
a
a
a
a
a
a
a
a
a
a
a
a
a
a
a
a
a
"}
