//MAP CONVERTED BY dmm2tgm.py THIS HEADER COMMENT PREVENTS RECONVERSION, DO NOT REMOVE
"a" = (
/turf/open/indestructible/ironsand,
/area/awaymission/PactDaivers)
"f" = (
/obj/effect/landmark/awaystart,
/obj/effect/turf_decal/weather/sand/plating,
/obj/structure/lattice/catwalk,
/turf/open/indestructible/ironsand,
/area/awaymission/PactDaivers)
"k" = (
/turf/open/floor/plating/ironsand{
	icon_state = "ironsand9"
	},
/area/awaymission/PactDaivers)
"m" = (
/turf/open/floor/plating/ironsand{
	icon_state = "ironsand2"
	},
/area/awaymission/PactDaivers)
"n" = (
/obj/item/ammo_box/magazine/hellgate_vp78,
/obj/item/ammo_box/magazine/hellgate_vp78,
/obj/item/ammo_box/magazine/hellgate_vp78,
/obj/item/gun/ballistic/automatic/pistol/hellgate_vp78,
/obj/item/ammo_box/c10mm,
/obj/item/ammo_box/c10mm,
/obj/item/ammo_box/c10mm,
/obj/item/ammo_box/c10mm,
/obj/item/ammo_box/c10mm,
/obj/item/ammo_box/c10mm,
/obj/structure/urbanismbigcrate/alt,
/obj/effect/turf_decal/weather/sand/plating,
/obj/item/reagent_containers/hypospray/medipen/stimpack/traitor,
/turf/open/indestructible/ironsand,
/area/awaymission/PactDaivers)
"w" = (
/obj/effect/turf_decal/weather/sand/plating,
/obj/structure/lattice/catwalk,
/obj/structure/lattice/catwalk,
/turf/open/indestructible/ironsand,
/area/awaymission/PactDaivers)
"y" = (
/obj/item/ammo_box/magazine/hellgate_vp78,
/obj/item/ammo_box/magazine/hellgate_vp78,
/obj/item/ammo_box/magazine/hellgate_vp78,
/obj/item/gun/ballistic/automatic/pistol/hellgate_vp78,
/obj/item/ammo_box/c10mm,
/obj/item/ammo_box/c10mm,
/obj/item/ammo_box/c10mm,
/obj/item/ammo_box/c10mm,
/obj/item/ammo_box/c10mm,
/obj/item/ammo_box/c10mm,
/obj/structure/urbanismbigcrate/alt,
/obj/item/reagent_containers/hypospray/medipen/stimpack/traitor,
/turf/open/indestructible/ironsand,
/area/awaymission/PactDaivers)
"A" = (
/obj/effect/landmark/awaystart,
/obj/effect/turf_decal/weather/sand/plating,
/turf/open/indestructible/ironsand,
/area/awaymission/PactDaivers)
"J" = (
/obj/item/ammo_box/magazine/hellgate_vp78,
/obj/item/ammo_box/magazine/hellgate_vp78,
/obj/item/ammo_box/magazine/hellgate_vp78,
/obj/item/gun/ballistic/automatic/pistol/hellgate_vp78,
/obj/item/ammo_box/c10mm,
/obj/item/ammo_box/c10mm,
/obj/item/ammo_box/c10mm,
/obj/item/ammo_box/c10mm,
/obj/item/ammo_box/c10mm,
/obj/item/ammo_box/c10mm,
/obj/structure/urbanismbigcrate/alt,
/obj/effect/turf_decal/weather/sand/plating,
/obj/structure/lattice/catwalk,
/obj/item/reagent_containers/hypospray/medipen/stimpack/traitor,
/turf/open/indestructible/ironsand,
/area/awaymission/PactDaivers)
"K" = (
/obj/effect/turf_decal/weather/sand/plating,
/obj/structure/lattice/catwalk,
/turf/open/indestructible/ironsand,
/area/awaymission/PactDaivers)
"N" = (
/obj/effect/decal/cleanable/wrapping,
/obj/effect/turf_decal/weather/sand/plating,
/turf/open/indestructible/ironsand,
/area/awaymission/PactDaivers)
"P" = (
/obj/effect/decal/cleanable/wrapping,
/turf/open/indestructible/ironsand,
/area/awaymission/PactDaivers)
"W" = (
/obj/structure/hellgate_dropship,
/obj/effect/turf_decal/weather/sand/plating,
/turf/open/indestructible/ironsand,
/area/awaymission/PactDaivers)
"Z" = (
/obj/effect/turf_decal/weather/sand/plating,
/turf/open/indestructible/ironsand,
/area/awaymission/PactDaivers)

(1,1,1) = {"
a
a
a
a
a
a
a
a
a
a
a
a
a
a
a
a
a
a
a
a
"}
(2,1,1) = {"
m
P
a
a
a
m
a
a
a
a
a
a
a
a
a
a
a
a
a
a
"}
(3,1,1) = {"
a
m
k
a
a
a
P
a
m
a
a
k
a
a
a
a
m
m
a
a
"}
(4,1,1) = {"
a
m
P
a
a
a
a
a
a
a
a
P
m
a
a
a
a
P
a
a
"}
(5,1,1) = {"
a
a
a
a
a
a
y
a
a
a
a
a
a
m
P
a
a
a
a
a
"}
(6,1,1) = {"
a
a
a
a
a
K
K
f
K
K
K
f
K
w
a
a
a
a
a
a
"}
(7,1,1) = {"
a
a
a
a
a
K
Z
Z
Z
Z
Z
Z
Z
K
m
a
a
a
a
a
"}
(8,1,1) = {"
a
k
m
P
a
K
Z
Z
Z
Z
n
Z
W
K
a
a
a
k
a
a
"}
(9,1,1) = {"
a
m
a
a
a
K
Z
Z
Z
Z
Z
Z
Z
K
a
P
a
a
a
a
"}
(10,1,1) = {"
a
a
a
a
a
K
Z
Z
Z
Z
Z
Z
Z
K
a
a
a
a
a
a
"}
(11,1,1) = {"
a
a
a
a
a
K
Z
Z
Z
Z
Z
Z
Z
K
a
a
a
m
a
a
"}
(12,1,1) = {"
a
m
a
m
a
K
Z
Z
N
Z
Z
Z
Z
K
k
a
a
a
a
a
"}
(13,1,1) = {"
a
a
a
P
a
K
Z
A
Z
Z
Z
A
n
K
a
a
a
a
a
a
"}
(14,1,1) = {"
a
a
a
a
a
K
K
J
K
K
K
K
K
K
a
a
a
P
a
a
"}
(15,1,1) = {"
a
k
a
a
a
a
a
a
a
a
a
a
a
a
a
a
a
a
k
a
"}
(16,1,1) = {"
a
a
a
a
k
a
a
a
a
a
a
a
a
m
a
a
a
a
a
a
"}
(17,1,1) = {"
a
P
a
a
m
a
a
a
a
k
a
a
a
a
a
a
a
a
a
a
"}
(18,1,1) = {"
a
a
a
a
m
P
a
a
a
a
m
P
a
a
a
k
a
a
a
a
"}
(19,1,1) = {"
a
a
a
m
a
a
a
a
a
a
a
a
a
a
a
a
a
a
a
a
"}
(20,1,1) = {"
a
a
a
a
a
a
a
a
a
a
a
a
a
a
a
a
a
a
a
a
"}
