//MAP CONVERTED BY dmm2tgm.py THIS HEADER COMMENT PREVENTS RECONVERSION, DO NOT REMOVE
"aa" = (
/obj/structure/window/reinforced/survival_pod{
	dir = 4
	},
/turf/open/floor/pod/dark,
/area/shuttle/golems)
"av" = (
/obj/item/resonator,
/obj/structure/rack,
/obj/effect/turf_decal/box/yellow/corners,
/turf/open/floor/pod/dark,
/area/shuttle/golems)
"bF" = (
/obj/structure/window/reinforced/survival_pod{
	dir = 8
	},
/obj/effect/turf_decal/siding/yellow{
	dir = 8
	},
/turf/open/floor/pod/dark,
/area/shuttle/golems)
"em" = (
/obj/structure/window/shuttle/survival_pod,
/turf/open/floor/pod/dark,
/area/shuttle/golems)
"fb" = (
/obj/structure/chair/comfy/shuttle{
	dir = 4
	},
/obj/effect/turf_decal/bot/white,
/turf/open/floor/pod/dark,
/area/shuttle/golems)
"fg" = (
/obj/item/resonator,
/obj/structure/rack,
/obj/effect/turf_decal/box/yellow/corners{
	dir = 4
	},
/turf/open/floor/pod/dark,
/area/shuttle/golems)
"fl" = (
/obj/structure/table/reinforced/ctf,
/obj/item/disk/design_disk/golem_shell,
/turf/open/floor/pod/dark,
/area/shuttle/golems)
"fr" = (
/obj/structure/closet/crate,
/obj/item/shovel,
/obj/item/shovel,
/obj/item/shovel,
/obj/item/pickaxe,
/obj/item/pickaxe,
/obj/item/pickaxe,
/obj/item/storage/bag/ore,
/obj/item/storage/bag/ore,
/obj/item/mining_scanner,
/obj/item/flashlight/lantern,
/obj/item/card/id/mining,
/obj/item/gps/mining/off,
/turf/open/floor/pod/dark,
/area/shuttle/golems)
"fY" = (
/obj/effect/mob_spawn/human/golem/adamantine,
/turf/open/floor/pod/dark,
/area/shuttle/golems)
"go" = (
/obj/structure/extinguisher_cabinet{
	pixel_y = 30
	},
/turf/open/floor/pod/dark,
/area/shuttle/golems)
"hA" = (
/obj/structure/ore_box,
/turf/open/floor/pod/dark,
/area/shuttle/golems)
"hF" = (
/obj/effect/turf_decal/stripes/yellow,
/obj/machinery/light{
	dir = 4
	},
/turf/open/floor/pod/dark,
/area/shuttle/golems)
"hG" = (
/obj/effect/turf_decal/box/yellow,
/turf/open/floor/pod/dark,
/area/shuttle/golems)
"jd" = (
/obj/structure/chair/comfy/shuttle{
	dir = 8
	},
/turf/open/floor/pod/dark,
/area/shuttle/golems)
"jw" = (
/obj/effect/turf_decal/delivery,
/obj/machinery/light{
	dir = 4
	},
/turf/open/floor/pod/dark,
/area/shuttle/golems)
"jx" = (
/obj/structure/table/reinforced/ctf,
/obj/item/surgical_drapes{
	pixel_x = -3;
	pixel_y = 0
	},
/turf/open/floor/pod/dark,
/area/shuttle/golems)
"jB" = (
/obj/structure/window/reinforced/survival_pod,
/obj/effect/turf_decal/siding/dark_green,
/turf/open/floor/pod/dark,
/area/shuttle/golems)
"jU" = (
/obj/structure/table/reinforced/ctf,
/obj/item/storage/toolbox/mechanical,
/turf/open/floor/pod/dark,
/area/shuttle/golems)
"km" = (
/obj/structure/window/reinforced/survival_pod{
	dir = 9
	},
/obj/effect/turf_decal/siding/yellow{
	dir = 8
	},
/turf/open/floor/pod/dark,
/area/shuttle/golems)
"kX" = (
/obj/item/storage/firstaid/brute,
/obj/item/storage/firstaid/brute,
/obj/structure/table/reinforced/ctf,
/obj/machinery/light,
/turf/open/floor/pod/dark,
/area/shuttle/golems)
"kZ" = (
/obj/structure/fans/tiny,
/obj/effect/mapping_helpers/airlock/cyclelink_helper{
	dir = 1
	},
/obj/machinery/door/airlock/survival_pod,
/turf/open/floor/pod/dark,
/area/shuttle/golems)
"lc" = (
/obj/structure/table/reinforced/ctf,
/turf/open/floor/pod/dark,
/area/shuttle/golems)
"lm" = (
/obj/machinery/door/airlock/survival_pod,
/turf/open/floor/pod/dark,
/area/shuttle/golems)
"lw" = (
/obj/structure/table/reinforced/ctf,
/obj/item/storage/firstaid/fire,
/obj/item/storage/firstaid/fire,
/turf/open/floor/pod/dark,
/area/shuttle/golems)
"ly" = (
/obj/item/storage/firstaid/fire,
/obj/item/storage/firstaid/fire,
/obj/structure/table/reinforced/ctf,
/turf/open/floor/pod/dark,
/area/shuttle/golems)
"mm" = (
/obj/effect/turf_decal/siding/yellow{
	dir = 1
	},
/turf/open/floor/pod/dark,
/area/shuttle/golems)
"mQ" = (
/obj/effect/turf_decal/siding/yellow{
	dir = 6
	},
/turf/open/floor/pod/dark,
/area/shuttle/golems)
"mY" = (
/obj/structure/statue/gold/rd,
/obj/machinery/light{
	dir = 8
	},
/obj/structure/window/reinforced/survival_pod{
	dir = 4
	},
/obj/effect/turf_decal/siding/yellow{
	dir = 4
	},
/turf/open/floor/pod/dark,
/area/shuttle/golems)
"nM" = (
/obj/machinery/light{
	dir = 8
	},
/turf/open/floor/pod/dark,
/area/shuttle/golems)
"oy" = (
/obj/structure/window/reinforced/survival_pod{
	dir = 8
	},
/obj/effect/turf_decal/siding/dark_green{
	dir = 8
	},
/turf/open/floor/pod/dark,
/area/shuttle/golems)
"oH" = (
/obj/effect/turf_decal/siding/yellow{
	dir = 8
	},
/turf/open/floor/pod/dark,
/area/shuttle/golems)
"oR" = (
/obj/machinery/reagentgrinder,
/obj/structure/table/reinforced/ctf,
/turf/open/floor/pod/dark,
/area/shuttle/golems)
"pv" = (
/obj/machinery/light,
/turf/open/floor/pod/dark,
/area/shuttle/golems)
"pE" = (
/obj/structure/closet/crate,
/obj/item/shovel,
/obj/item/shovel,
/obj/item/pickaxe,
/obj/item/pickaxe,
/obj/item/storage/bag/ore,
/obj/item/storage/bag/ore,
/obj/item/mining_scanner,
/obj/item/flashlight/lantern,
/obj/item/card/id/mining,
/obj/item/gps/mining/off,
/obj/machinery/light,
/turf/open/floor/pod/dark,
/area/shuttle/golems)
"pW" = (
/obj/machinery/door/airlock/survival_pod/glass,
/obj/effect/mapping_helpers/airlock/cyclelink_helper,
/turf/open/floor/pod/dark,
/area/shuttle/golems)
"ql" = (
/obj/machinery/door/airlock/survival_pod/glass,
/turf/open/floor/pod/dark,
/area/shuttle/golems)
"qB" = (
/obj/machinery/mineral/ore_redemption,
/turf/open/floor/pod/dark,
/area/shuttle/golems)
"rB" = (
/obj/machinery/door/window/survival_pod{
	dir = 8
	},
/turf/open/floor/pod/dark,
/area/shuttle/golems)
"sf" = (
/obj/structure/reagent_dispensers/watertank,
/turf/open/floor/pod/dark,
/area/shuttle/golems)
"sE" = (
/obj/machinery/computer/arcade/battle,
/turf/open/floor/pod/dark,
/area/shuttle/golems)
"sQ" = (
/turf/closed/wall/mineral/titanium/survival/nodiagonal,
/area/shuttle/golems)
"tb" = (
/turf/closed/wall/mineral/titanium/survival,
/area/shuttle/golems)
"tr" = (
/obj/effect/turf_decal/siding/yellow{
	dir = 9
	},
/turf/open/floor/pod/dark,
/area/shuttle/golems)
"uw" = (
/obj/machinery/computer/camera_advanced/shuttle_docker/golems{
	dir = 8
	},
/turf/open/floor/pod/dark,
/area/shuttle/golems)
"uE" = (
/obj/structure/chair/comfy/shuttle{
	dir = 4
	},
/turf/open/floor/pod/dark,
/area/shuttle/golems)
"vi" = (
/obj/machinery/door/airlock/survival_pod/glass,
/obj/effect/mapping_helpers/airlock/cyclelink_helper{
	dir = 1
	},
/turf/open/floor/pod/dark,
/area/shuttle/golems)
"vl" = (
/obj/machinery/light{
	dir = 1
	},
/turf/open/floor/pod/dark,
/area/shuttle/golems)
"wd" = (
/obj/effect/turf_decal/stripes/yellow{
	dir = 1
	},
/obj/machinery/light{
	dir = 4
	},
/turf/open/floor/pod/dark,
/area/shuttle/golems)
"wu" = (
/obj/structure/ore_box,
/obj/effect/turf_decal/delivery,
/turf/open/floor/pod/dark,
/area/shuttle/golems)
"wJ" = (
/obj/machinery/computer{
	desc = "A computer long since rendered non-functional due to lack of maintenance. Spitting out error messages.";
	dir = 8;
	name = "Broken Computer"
	},
/turf/open/floor/pod/dark,
/area/shuttle/golems)
"xm" = (
/obj/structure/table/wood,
/obj/item/bedsheet/rd/royal_cape{
	layer = 3;
	pixel_x = 5;
	pixel_y = 9
	},
/obj/item/book/manual/wiki/research_and_development{
	name = "Sacred Text of the Liberator";
	pixel_x = -4;
	pixel_y = 3
	},
/obj/item/tcg_card/special/golem,
/obj/structure/window/reinforced/survival_pod{
	dir = 4
	},
/obj/effect/turf_decal/siding/yellow{
	dir = 4
	},
/turf/open/floor/pod/dark,
/area/shuttle/golems)
"xo" = (
/obj/structure/frame/computer,
/turf/open/floor/pod/dark,
/area/shuttle/golems)
"xw" = (
/obj/machinery/mineral/equipment_vendor/golem,
/turf/open/floor/pod/dark,
/area/shuttle/golems)
"zL" = (
/obj/structure/table/reinforced/ctf,
/obj/item/gps/mining{
	pixel_x = -9;
	pixel_y = 6
	},
/turf/open/floor/pod/dark,
/area/shuttle/golems)
"AD" = (
/obj/effect/turf_decal/siding/yellow{
	dir = 5
	},
/turf/open/floor/pod/dark,
/area/shuttle/golems)
"Bd" = (
/obj/structure/closet/crate,
/obj/item/shovel,
/obj/item/shovel,
/obj/item/shovel,
/obj/item/pickaxe,
/obj/item/pickaxe,
/obj/item/pickaxe,
/obj/item/storage/bag/ore,
/obj/item/storage/bag/ore,
/obj/item/mining_scanner,
/obj/item/flashlight/lantern,
/obj/item/card/id/mining,
/obj/item/gps/mining/off,
/obj/machinery/light{
	dir = 1
	},
/turf/open/floor/pod/dark,
/area/shuttle/golems)
"Ch" = (
/obj/effect/turf_decal/siding/yellow{
	dir = 4
	},
/turf/open/floor/pod/dark,
/area/shuttle/golems)
"Eg" = (
/obj/effect/turf_decal/siding/yellow/corner{
	dir = 1
	},
/turf/open/floor/pod/dark,
/area/shuttle/golems)
"Et" = (
/obj/machinery/light{
	dir = 8
	},
/obj/effect/turf_decal/siding/yellow{
	dir = 8
	},
/turf/open/floor/pod/dark,
/area/shuttle/golems)
"ES" = (
/obj/structure/table/reinforced/ctf,
/obj/item/areaeditor/blueprints{
	desc = "Use to build new structures in the wastes.";
	name = "land claim"
	},
/obj/machinery/light,
/turf/open/floor/pod/dark,
/area/shuttle/golems)
"FP" = (
/obj/item/resonator,
/obj/structure/rack,
/obj/effect/turf_decal/box/yellow/corners{
	dir = 8
	},
/turf/open/floor/pod/dark,
/area/shuttle/golems)
"Gs" = (
/obj/effect/turf_decal/siding/dark_green{
	dir = 8
	},
/turf/open/floor/pod/dark,
/area/shuttle/golems)
"ID" = (
/obj/machinery/autolathe,
/turf/open/floor/pod/dark,
/area/shuttle/golems)
"JI" = (
/obj/effect/turf_decal/siding/yellow/corner{
	dir = 4
	},
/turf/open/floor/pod/dark,
/area/shuttle/golems)
"JV" = (
/obj/effect/turf_decal/siding/yellow/corner,
/turf/open/floor/pod/dark,
/area/shuttle/golems)
"JW" = (
/obj/item/storage/firstaid/brute,
/obj/item/storage/firstaid/brute,
/obj/structure/table/reinforced/ctf,
/turf/open/floor/pod/dark,
/area/shuttle/golems)
"Ki" = (
/obj/structure/frame/machine,
/turf/open/floor/pod/dark,
/area/shuttle/golems)
"Ln" = (
/obj/structure/window/reinforced/survival_pod{
	dir = 10
	},
/obj/effect/turf_decal/siding/dark_green/corner{
	dir = 8
	},
/turf/open/floor/pod/dark,
/area/shuttle/golems)
"Mh" = (
/obj/structure/frame/computer{
	dir = 8
	},
/turf/open/floor/pod/dark,
/area/shuttle/golems)
"Mr" = (
/obj/machinery/computer/arcade/orion_trail,
/turf/open/floor/pod/dark,
/area/shuttle/golems)
"MX" = (
/obj/machinery/computer/shuttle/golems{
	dir = 8
	},
/turf/open/floor/pod/dark,
/area/shuttle/golems)
"MZ" = (
/obj/structure/fans/tiny,
/obj/effect/mapping_helpers/airlock/cyclelink_helper,
/obj/machinery/door/airlock/survival_pod,
/turf/open/floor/pod/dark,
/area/shuttle/golems)
"Ni" = (
/obj/effect/turf_decal/siding/yellow{
	dir = 10
	},
/turf/open/floor/pod/dark,
/area/shuttle/golems)
"NO" = (
/obj/structure/window/reinforced/survival_pod{
	dir = 8
	},
/turf/open/floor/pod/dark,
/area/shuttle/golems)
"Oz" = (
/obj/structure/closet/crate,
/obj/item/storage/toolbox/mechanical,
/turf/open/floor/pod/dark,
/area/shuttle/golems)
"QE" = (
/obj/structure/closet/crate,
/obj/item/shovel,
/obj/item/shovel,
/obj/item/pickaxe,
/obj/item/pickaxe,
/obj/item/storage/bag/ore,
/obj/item/storage/bag/ore,
/obj/item/mining_scanner,
/obj/item/flashlight/lantern,
/obj/item/card/id/mining,
/obj/item/gps/mining/off,
/turf/open/floor/pod/dark,
/area/shuttle/golems)
"Sg" = (
/obj/structure/window/reinforced/survival_pod{
	dir = 1
	},
/obj/effect/turf_decal/siding/yellow{
	dir = 1
	},
/turf/open/floor/pod/dark,
/area/shuttle/golems)
"SL" = (
/obj/structure/shuttle/engine/huge{
	dir = 8
	},
/turf/template_noop,
/area/template_noop)
"SR" = (
/obj/structure/table/reinforced/ctf,
/obj/item/resonator/upgraded,
/obj/machinery/light{
	dir = 1
	},
/turf/open/floor/pod/dark,
/area/shuttle/golems)
"Ux" = (
/obj/structure/closet/crate,
/turf/open/floor/pod/dark,
/area/shuttle/golems)
"UD" = (
/obj/structure/table/reinforced/ctf,
/obj/structure/extinguisher_cabinet{
	pixel_y = -30
	},
/turf/open/floor/pod/dark,
/area/shuttle/golems)
"UM" = (
/obj/effect/turf_decal/siding/dark_green/corner,
/turf/open/floor/pod/dark,
/area/shuttle/golems)
"VI" = (
/obj/item/resonator,
/obj/structure/rack,
/obj/effect/turf_decal/box/yellow/corners{
	dir = 1
	},
/turf/open/floor/pod/dark,
/area/shuttle/golems)
"VY" = (
/obj/structure/reagent_dispensers/fueltank,
/turf/open/floor/pod/dark,
/area/shuttle/golems)
"WQ" = (
/turf/template_noop,
/area/template_noop)
"XU" = (
/obj/effect/turf_decal/stripes/yellow{
	dir = 1
	},
/turf/open/floor/pod/dark,
/area/shuttle/golems)
"Ye" = (
/turf/open/floor/pod/dark,
/area/shuttle/golems)
"YC" = (
/obj/effect/turf_decal/stripes/yellow,
/turf/open/floor/pod/dark,
/area/shuttle/golems)
"ZQ" = (
/obj/structure/closet/crate,
/obj/item/shovel,
/obj/item/shovel,
/obj/item/shovel,
/obj/item/pickaxe,
/obj/item/pickaxe,
/obj/item/pickaxe,
/obj/item/storage/bag/ore,
/obj/item/storage/bag/ore,
/obj/item/mining_scanner,
/obj/item/flashlight/lantern,
/obj/item/card/id/mining,
/obj/item/gps/mining/off,
/obj/machinery/light{
	dir = 8
	},
/turf/open/floor/pod/dark,
/area/shuttle/golems)

(1,1,1) = {"
WQ
WQ
WQ
WQ
WQ
WQ
WQ
WQ
WQ
WQ
WQ
WQ
WQ
WQ
WQ
WQ
WQ
WQ
WQ
"}
(2,1,1) = {"
WQ
WQ
WQ
SL
WQ
WQ
WQ
WQ
WQ
WQ
WQ
WQ
WQ
WQ
WQ
WQ
WQ
SL
WQ
"}
(3,1,1) = {"
tb
tb
tb
tb
tb
WQ
WQ
WQ
WQ
WQ
WQ
WQ
WQ
WQ
tb
tb
tb
tb
tb
"}
(4,1,1) = {"
tb
Ye
Ye
Ye
tb
WQ
WQ
tb
WQ
WQ
SL
tb
WQ
WQ
tb
Ye
Ye
Ye
tb
"}
(5,1,1) = {"
tb
tb
tb
tb
tb
WQ
WQ
tb
tb
tb
tb
tb
WQ
WQ
tb
tb
tb
tb
tb
"}
(6,1,1) = {"
tb
sE
nM
UM
sQ
tb
tb
tb
aa
aa
aa
tb
tb
tb
tb
fr
ZQ
hA
tb
"}
(7,1,1) = {"
tb
Mr
Ye
jB
Ki
Ye
Ki
tb
tb
tb
tb
sQ
mY
xm
tb
Ye
Ye
hA
tb
"}
(8,1,1) = {"
tb
tb
Ye
jB
Ki
Ye
Ki
tb
xo
nM
Ki
Sg
Ye
Ye
sQ
ql
tb
tb
tb
"}
(9,1,1) = {"
WQ
tb
Ye
jB
Ki
Ye
Ki
tb
Ki
Ye
Ki
Sg
Ye
Ye
mm
Ye
QE
tb
WQ
"}
(10,1,1) = {"
WQ
tb
Ye
Ln
oy
Gs
oy
tb
Ki
Ye
Ki
Sg
Ye
Ye
mm
Ye
pE
tb
WQ
"}
(11,1,1) = {"
WQ
tb
vl
Ye
Ye
Ye
Ye
tb
NO
Ye
bF
km
oH
oH
Eg
Ye
QE
tb
WQ
"}
(12,1,1) = {"
WQ
tb
Ux
Ye
Ye
Ye
Ye
lm
Ye
Ye
Ye
Ye
Ye
Ye
Ye
Ye
UD
tb
WQ
"}
(13,1,1) = {"
WQ
tb
tb
Ux
lc
oR
sf
tb
xw
Ye
wu
qB
jw
ID
fl
jU
tb
tb
WQ
"}
(14,1,1) = {"
WQ
WQ
tb
tb
tb
tb
tb
tb
tb
lm
tb
tb
tb
tb
tb
tb
tb
WQ
WQ
"}
(15,1,1) = {"
WQ
WQ
MZ
XU
YC
vi
tr
oH
Et
oH
Et
oH
Ni
pW
XU
YC
kZ
WQ
WQ
"}
(16,1,1) = {"
WQ
WQ
MZ
XU
hF
vi
AD
JI
Ye
Ye
Ye
JV
mQ
pW
wd
YC
kZ
WQ
WQ
"}
(17,1,1) = {"
WQ
WQ
tb
tb
tb
tb
tb
AD
Ch
Ch
Ch
mQ
tb
tb
tb
tb
tb
WQ
WQ
"}
(18,1,1) = {"
WQ
WQ
tb
fr
Ye
wu
tb
tb
tb
lm
tb
tb
tb
jx
ly
lw
tb
WQ
WQ
"}
(19,1,1) = {"
WQ
WQ
tb
Bd
Ye
Ye
wu
tb
fg
Ye
VI
tb
Ye
Ye
Ye
kX
tb
WQ
WQ
"}
(20,1,1) = {"
WQ
WQ
tb
fr
Ye
Ye
Ye
lm
Ye
hG
Ye
lm
Ye
Ye
Ye
JW
tb
WQ
WQ
"}
(21,1,1) = {"
WQ
WQ
tb
tb
fr
Ye
Oz
tb
vl
hG
pv
tb
go
Ye
sf
tb
tb
WQ
WQ
"}
(22,1,1) = {"
WQ
WQ
WQ
tb
tb
wu
wu
tb
FP
Ye
av
tb
VY
VY
tb
tb
WQ
WQ
WQ
"}
(23,1,1) = {"
WQ
WQ
WQ
WQ
tb
tb
tb
tb
tb
lm
tb
tb
tb
tb
tb
WQ
WQ
WQ
WQ
"}
(24,1,1) = {"
WQ
WQ
WQ
WQ
WQ
tb
SR
uE
fY
Ye
fY
uE
ES
tb
WQ
WQ
WQ
WQ
WQ
"}
(25,1,1) = {"
WQ
WQ
WQ
WQ
WQ
tb
zL
jd
fY
Ye
fY
jd
lc
tb
WQ
WQ
WQ
WQ
WQ
"}
(26,1,1) = {"
WQ
WQ
WQ
WQ
WQ
tb
tb
NO
NO
rB
NO
NO
tb
tb
WQ
WQ
WQ
WQ
WQ
"}
(27,1,1) = {"
WQ
WQ
WQ
WQ
WQ
WQ
em
uE
Ye
Ye
Ye
uE
em
WQ
WQ
WQ
WQ
WQ
WQ
"}
(28,1,1) = {"
WQ
WQ
WQ
WQ
WQ
WQ
em
wJ
fb
fb
fb
Mh
em
WQ
WQ
WQ
WQ
WQ
WQ
"}
(29,1,1) = {"
WQ
WQ
WQ
WQ
WQ
WQ
em
em
MX
uw
wJ
em
em
WQ
WQ
WQ
WQ
WQ
WQ
"}
(30,1,1) = {"
WQ
WQ
WQ
WQ
WQ
WQ
WQ
em
em
em
em
em
WQ
WQ
WQ
WQ
WQ
WQ
WQ
"}
