//MAP CONVERTED BY dmm2tgm.py THIS HEADER COMMENT PREVENTS RECONVERSION, DO NOT REMOVE
"aa" = (
/obj/effect/mapping_helpers/network_builder/power_cable/red/auto,
/turf/open/floor/plasteel/dark/textured/large,
/area/engineering/main)
"aW" = (
/obj/structure/lattice,
/obj/structure/grille,
/turf/open/space/basic,
/area/space/nearstation)
"bG" = (
/obj/machinery/atmospherics/pipe/simple/supply/hidden,
/obj/effect/spawner/structure/window,
/turf/open/floor/plating,
/area/engineering/main)
"bY" = (
/obj/structure/sign/warning/vacuum/external{
	pixel_x = 32
	},
/turf/open/floor/plating,
/area/engineering/main)
"cx" = (
/turf/closed/wall,
/area/engineering/main)
"em" = (
/obj/structure/weightmachine/weightlifter,
/turf/open/floor/plasteel/dark/textured/large,
/area/engineering/main)
"eq" = (
/obj/machinery/atmospherics/pipe/simple/supply/hidden{
	dir = 4
	},
/obj/structure/cable/yellow{
	icon_state = "0-8"
	},
/obj/machinery/power/smes,
/obj/machinery/camera/autoname,
/turf/open/floor/plasteel/dark/textured/large,
/area/engineering/main)
"fP" = (
/obj/structure/weightmachine/stacklifter,
/turf/open/floor/plasteel/dark/textured/large,
/area/engineering/main)
"gg" = (
/obj/effect/mapping_helpers/airlock/cyclelink_helper,
/obj/machinery/door/airlock/external{
	name = "Engineering External Access";
	req_access_txt = "10;13"
	},
/turf/open/floor/plating,
/area/engineering/main)
"hd" = (
/obj/structure/sign/poster/contraband/vulp7,
/turf/closed/wall/r_wall,
/area/engineering/main)
"hF" = (
/obj/structure/chair/pedalgen{
	dir = 4
	},
/obj/effect/mapping_helpers/network_builder/power_cable/red/knot,
/turf/open/floor/plasteel/dark/textured/large,
/area/engineering/main)
"hY" = (
/obj/structure/sign/poster/official/poster_vulp8,
/turf/closed/wall/r_wall,
/area/engineering/main)
"iA" = (
/obj/machinery/atmospherics/pipe/simple/scrubbers/hidden,
/obj/structure/closet/radiation,
/turf/open/floor/plasteel,
/area/engineering/main)
"jI" = (
/obj/machinery/atmospherics/pipe/simple/scrubbers/hidden{
	dir = 4
	},
/turf/open/floor/plasteel/dark/textured/large,
/area/engineering/main)
"mf" = (
/obj/effect/mapping_helpers/network_builder/power_cable/red/knot,
/obj/structure/chair/pedalgen,
/turf/open/floor/plasteel/dark/textured/large,
/area/engineering/main)
"mt" = (
/obj/structure/table,
/obj/item/clothing/gloves/color/yellow,
/obj/item/storage/toolbox/electrical{
	pixel_y = 5
	},
/turf/open/floor/plasteel,
/area/engineering/main)
"my" = (
/obj/machinery/atmospherics/pipe/simple/scrubbers/hidden{
	dir = 5
	},
/turf/open/floor/plasteel/dark/textured/large,
/area/engineering/main)
"nx" = (
/obj/structure/sign/poster/contraband/lusty_xenomorph,
/turf/closed/wall/r_wall,
/area/engineering/main)
"nL" = (
/obj/machinery/atmospherics/pipe/simple/supply/hidden{
	dir = 4
	},
/obj/machinery/vending/cola/red,
/turf/open/floor/plasteel/dark/textured/large,
/area/engineering/main)
"pj" = (
/obj/machinery/atmospherics/pipe/manifold/scrubbers/hidden,
/obj/machinery/door/firedoor,
/obj/machinery/door/airlock/engineering/glass{
	name = "Power Generation";
	req_access_txt = "10"
	},
/turf/open/floor/plasteel/dark/textured/large,
/area/engineering/main)
"rK" = (
/obj/machinery/atmospherics/pipe/simple/supply/hidden{
	dir = 4
	},
/turf/open/floor/plasteel/dark/textured/large,
/area/engineering/main)
"rS" = (
/obj/effect/mapping_helpers/airlock/cyclelink_helper{
	dir = 1
	},
/obj/machinery/door/airlock/external{
	name = "Engineering External Access";
	req_access_txt = "10;13"
	},
/obj/structure/fans/tiny,
/turf/open/floor/plating,
/area/engineering/main)
"sn" = (
/obj/machinery/atmospherics/pipe/simple/orange/visible{
	dir = 4
	},
/obj/machinery/meter,
/turf/open/floor/plasteel,
/area/engineering/main)
"sA" = (
/obj/machinery/atmospherics/pipe/simple/supply/hidden{
	dir = 4
	},
/obj/structure/cable/yellow{
	icon_state = "4-8"
	},
/obj/effect/spawner/structure/window,
/turf/open/floor/plating,
/area/engineering/main)
"sY" = (
/obj/structure/cable/yellow{
	icon_state = "4-8"
	},
/obj/machinery/atmospherics/pipe/simple/supply/hidden{
	dir = 4
	},
/obj/machinery/light{
	dir = 1
	},
/obj/structure/closet/secure_closet/personal,
/obj/machinery/firealarm/directional/north,
/turf/open/floor/plasteel/dark/textured/large,
/area/engineering/main)
"to" = (
/turf/closed/wall/r_wall,
/area/engineering/main)
"tw" = (
/obj/structure/lattice,
/turf/open/space/basic,
/area/space/nearstation)
"tM" = (
/obj/machinery/atmospherics/pipe/simple/scrubbers/hidden,
/obj/machinery/atmospherics/pipe/simple/supply/hidden{
	dir = 4
	},
/obj/effect/spawner/structure/window,
/turf/open/floor/plating,
/area/engineering/main)
"ur" = (
/obj/effect/spawner/structure/window,
/obj/machinery/atmospherics/pipe/simple/supply/hidden{
	dir = 4
	},
/turf/open/floor/plating,
/area/engineering/main)
"uI" = (
/obj/structure/punching_bag,
/turf/open/floor/plasteel/dark/textured/large,
/area/engineering/main)
"wp" = (
/obj/structure/chair/pedalgen{
	dir = 8
	},
/obj/effect/mapping_helpers/network_builder/power_cable/red/knot,
/turf/open/floor/plasteel/dark/textured/large,
/area/engineering/main)
"xX" = (
/obj/machinery/atmospherics/pipe/simple/scrubbers/hidden{
	dir = 4
	},
/turf/closed/wall/r_wall,
/area/engineering/main)
"yk" = (
/obj/machinery/atmospherics/pipe/simple/scrubbers/hidden{
	dir = 9
	},
/obj/effect/spawner/structure/window,
/turf/open/floor/plating,
/area/engineering/main)
"zC" = (
/obj/effect/spawner/structure/window,
/turf/open/floor/plating,
/area/engineering/main)
"zL" = (
/obj/structure/cable/yellow{
	icon_state = "4-8"
	},
/obj/machinery/atmospherics/pipe/simple/supply/hidden{
	dir = 4
	},
/obj/structure/closet/secure_closet/personal,
/turf/open/floor/plasteel/dark/textured/large,
/area/engineering/main)
"zS" = (
/turf/open/space/basic,
/area/space)
"Be" = (
/obj/machinery/light/small{
	dir = 8
	},
/obj/structure/closet/emcloset/anchored,
/turf/open/floor/plating,
/area/engineering/main)
"Cc" = (
/obj/machinery/atmospherics/pipe/manifold/scrubbers/hidden{
	dir = 1
	},
/turf/open/floor/plasteel/dark/textured/large,
/area/engineering/main)
"Ck" = (
/obj/machinery/atmospherics/pipe/simple/supply/hidden{
	dir = 4
	},
/obj/structure/chair/stool,
/turf/open/floor/plasteel/dark/textured/large,
/area/engineering/main)
"CB" = (
/obj/structure/rack,
/obj/item/clothing/mask/gas{
	pixel_x = -3;
	pixel_y = -3
	},
/obj/item/clothing/mask/gas,
/obj/item/clothing/mask/gas{
	pixel_x = 3;
	pixel_y = 3
	},
/turf/open/floor/plasteel,
/area/engineering/main)
"Dy" = (
/obj/structure/table,
/obj/item/storage/part_replacer/bluespace/tier2,
/obj/machinery/atmospherics/pipe/manifold/supply/hidden{
	dir = 1
	},
/turf/open/floor/plasteel/dark/textured/large,
/area/engineering/main)
"EI" = (
/obj/structure/cable/yellow{
	icon_state = "4-8"
	},
/obj/machinery/atmospherics/pipe/manifold4w/supply/hidden,
/obj/structure/closet/secure_closet/personal,
/turf/open/floor/plasteel/dark/textured/large,
/area/engineering/main)
"Hu" = (
/obj/machinery/atmospherics/pipe/simple/orange/visible{
	dir = 5
	},
/turf/open/floor/plasteel,
/area/engineering/main)
"Ie" = (
/obj/structure/sign/poster/official/secfish,
/turf/closed/wall/r_wall,
/area/engineering/main)
"Jv" = (
/turf/open/floor/plasteel/dark/textured/large,
/area/engineering/main)
"JX" = (
/obj/machinery/atmospherics/components/unary/vent_scrubber/on{
	dir = 1
	},
/turf/open/floor/plasteel/dark/textured/large,
/area/engineering/main)
"Ka" = (
/obj/structure/cable/yellow{
	icon_state = "4-8"
	},
/obj/machinery/atmospherics/pipe/simple/supply/hidden{
	dir = 4
	},
/turf/open/floor/plasteel/dark/textured/large,
/area/engineering/main)
"Le" = (
/obj/structure/lattice/catwalk,
/turf/open/space/basic,
/area/space/nearstation)
"MD" = (
/obj/machinery/atmospherics/pipe/simple/scrubbers/hidden{
	dir = 4
	},
/obj/machinery/power/terminal{
	dir = 1
	},
/obj/structure/cable{
	icon_state = "0-2"
	},
/turf/open/floor/plasteel/dark/textured/large,
/area/engineering/main)
"NP" = (
/obj/machinery/atmospherics/pipe/manifold/scrubbers/hidden{
	dir = 1
	},
/obj/effect/spawner/structure/window,
/turf/open/floor/plating,
/area/engineering/main)
"Oj" = (
/turf/closed/wall/r_wall,
/area/space/nearstation)
"Po" = (
/obj/structure/cable/yellow{
	icon_state = "4-8"
	},
/obj/machinery/atmospherics/pipe/simple/supply/hidden{
	dir = 4
	},
/obj/structure/closet/athletic_mixed,
/turf/open/floor/plasteel/dark/textured/large,
/area/engineering/main)
"Qi" = (
/obj/machinery/atmospherics/components/unary/vent_pump/on{
	dir = 1
	},
/turf/open/floor/plasteel/dark/textured/large,
/area/engineering/main)
"Qr" = (
/obj/structure/table,
/obj/item/storage/toolbox/mechanical{
	pixel_y = 5
	},
/obj/item/flashlight{
	pixel_x = 1;
	pixel_y = 5
	},
/obj/item/flashlight{
	pixel_x = 1;
	pixel_y = 5
	},
/turf/open/floor/plasteel,
/area/engineering/main)
"QX" = (
/obj/machinery/atmospherics/pipe/simple/scrubbers/hidden{
	dir = 4
	},
/obj/machinery/atmospherics/pipe/simple/supply/hidden,
/turf/open/floor/plasteel/dark/textured/large,
/area/engineering/main)
"Rh" = (
/obj/structure/lattice,
/turf/open/space,
/area/space/nearstation)
"Sn" = (
/obj/structure/cable/yellow{
	icon_state = "4-8"
	},
/obj/machinery/atmospherics/pipe/simple/supply/hidden{
	dir = 4
	},
/obj/machinery/atmospherics/pipe/simple/scrubbers/hidden,
/obj/effect/spawner/structure/window,
/turf/open/floor/plating,
/area/engineering/main)
"Ss" = (
/obj/structure/sign/poster/contraband/lusty2,
/turf/closed/wall/r_wall,
/area/engineering/main)
"SZ" = (
/obj/machinery/atmospherics/pipe/simple/supply/hidden{
	dir = 4
	},
/obj/machinery/vending/snack/orange,
/turf/open/floor/plasteel/dark/textured/large,
/area/engineering/main)
"TR" = (
/obj/machinery/light,
/turf/open/floor/plasteel/dark/textured/large,
/area/engineering/main)
"Un" = (
/turf/open/floor/plasteel,
/area/engineering/main)
"WU" = (
/obj/machinery/atmospherics/pipe/simple/supply/hidden{
	dir = 4
	},
/obj/machinery/light{
	dir = 1
	},
/obj/structure/extinguisher_cabinet/directional/north,
/obj/structure/table,
/obj/item/storage/box/monkeycubes,
/turf/open/floor/plasteel/dark/textured/large,
/area/engineering/main)
"XX" = (
/obj/machinery/atmospherics/pipe/simple/orange/visible{
	dir = 10
	},
/turf/open/floor/plasteel,
/area/engineering/main)
"YZ" = (
/obj/structure/lattice,
/obj/structure/grille,
/turf/open/space,
/area/space/nearstation)
"ZF" = (
/obj/machinery/door/firedoor,
/obj/machinery/door/airlock/engineering/glass{
	name = "Power Generation";
	req_access_txt = "10"
	},
/turf/open/floor/plasteel/dark/textured/large,
/area/engineering/main)
"ZT" = (
/turf/template_noop,
/area/template_noop)

(1,1,1) = {"
ZT
ZT
ZT
ZT
ZT
ZT
ZT
zS
Rh
zS
zS
Rh
zS
zS
Rh
zS
zS
zS
YZ
YZ
YZ
ZT
ZT
ZT
ZT
ZT
"}
(2,1,1) = {"
ZT
ZT
ZT
ZT
ZT
ZT
ZT
zS
tw
zS
zS
tw
zS
zS
tw
zS
zS
zS
YZ
Oj
YZ
ZT
ZT
ZT
ZT
ZT
"}
(3,1,1) = {"
ZT
ZT
ZT
ZT
ZT
ZT
ZT
tw
tw
tw
tw
tw
tw
tw
tw
tw
Rh
Rh
YZ
Oj
YZ
ZT
ZT
ZT
ZT
ZT
"}
(4,1,1) = {"
ZT
ZT
ZT
ZT
ZT
ZT
ZT
Le
tw
Le
Le
tw
Le
Le
tw
Le
Le
Le
YZ
Oj
YZ
ZT
ZT
ZT
ZT
ZT
"}
(5,1,1) = {"
ZT
ZT
ZT
ZT
ZT
ZT
ZT
tw
tw
tw
tw
tw
tw
tw
tw
tw
Rh
Rh
YZ
Oj
YZ
ZT
ZT
ZT
ZT
ZT
"}
(6,1,1) = {"
ZT
ZT
ZT
ZT
ZT
ZT
ZT
Le
tw
Le
Le
tw
Le
Le
tw
Le
Le
Le
YZ
Oj
YZ
ZT
ZT
ZT
ZT
ZT
"}
(7,1,1) = {"
ZT
ZT
ZT
ZT
cx
cx
to
tw
tw
tw
tw
tw
tw
tw
tw
tw
Rh
Rh
YZ
Oj
YZ
zS
zS
zS
zS
zS
"}
(8,1,1) = {"
ZT
ZT
mt
Qr
cx
Be
to
Le
tw
Le
Le
tw
Le
Le
tw
Le
Le
Le
YZ
Oj
YZ
zS
zS
zS
zS
zS
"}
(9,1,1) = {"
ZT
ZT
Un
Un
gg
bY
rS
tw
tw
tw
tw
tw
tw
tw
tw
tw
Rh
Rh
YZ
YZ
YZ
tw
zS
zS
zS
zS
"}
(10,1,1) = {"
ZT
sA
ZF
zC
to
to
to
zS
zS
zS
zS
zS
zS
zS
tw
zS
tw
zS
zS
Rh
zS
zS
zS
zS
zS
zS
"}
(11,1,1) = {"
NP
Sn
my
Jv
fP
Jv
zC
zS
zS
zS
zS
zS
zS
zS
tw
tw
tw
tw
aW
YZ
aW
zS
zS
zS
zS
zS
"}
(12,1,1) = {"
xX
zL
jI
Jv
Jv
Jv
zC
zS
zS
zS
zS
zS
zS
zS
tw
zS
tw
zS
YZ
Oj
YZ
zS
zS
zS
zS
zS
"}
(13,1,1) = {"
yk
zL
Cc
JX
uI
Jv
zC
zS
zS
zS
zS
zS
zS
zS
tw
zS
tw
zS
YZ
Oj
YZ
zS
zS
zS
zS
zS
"}
(14,1,1) = {"
bG
EI
QX
Qi
Jv
TR
Ss
zS
zS
zS
zS
zS
zS
zS
tw
tw
tw
tw
YZ
Oj
YZ
Rh
zS
zS
zS
zS
"}
(15,1,1) = {"
to
sY
jI
wp
aa
wp
zC
zS
zS
zS
zS
zS
zS
zS
tw
zS
tw
zS
YZ
Oj
YZ
zS
zS
zS
zS
zS
"}
(16,1,1) = {"
nx
Po
jI
Jv
Jv
aa
zC
zS
zS
zS
zS
zS
zS
zS
tw
tw
tw
tw
YZ
Oj
YZ
zS
zS
zS
zS
zS
"}
(17,1,1) = {"
ZF
Ka
jI
Jv
Jv
mf
zC
zS
zS
zS
zS
zS
zS
zS
tw
zS
tw
zS
YZ
Oj
YZ
zS
zS
zS
zS
zS
"}
(18,1,1) = {"
zC
eq
MD
aa
aa
aa
hd
zS
zS
zS
zS
zS
zS
zS
tw
zS
tw
zS
YZ
Oj
YZ
zS
zS
zS
zS
zS
"}
(19,1,1) = {"
ZF
rK
jI
Jv
Jv
mf
zC
zS
zS
zS
zS
zS
zS
zS
tw
tw
tw
tw
YZ
Oj
YZ
zS
zS
zS
zS
zS
"}
(20,1,1) = {"
Ie
Ck
jI
Jv
Jv
aa
zC
zS
zS
zS
zS
zS
zS
zS
tw
tw
tw
tw
YZ
Oj
YZ
zS
zS
zS
zS
zS
"}
(21,1,1) = {"
to
WU
jI
hF
aa
hF
zC
zS
zS
zS
zS
zS
zS
zS
tw
zS
tw
zS
YZ
Oj
YZ
zS
zS
zS
zS
zS
"}
(22,1,1) = {"
zC
Dy
QX
Qi
Jv
TR
hY
zS
zS
zS
zS
zS
zS
zS
tw
tw
tw
tw
YZ
Oj
YZ
Rh
zS
zS
zS
zS
"}
(23,1,1) = {"
zC
SZ
Cc
JX
uI
Jv
zC
zS
zS
zS
zS
zS
zS
zS
tw
tw
tw
tw
YZ
Oj
YZ
zS
zS
zS
zS
zS
"}
(24,1,1) = {"
to
nL
jI
Jv
Jv
Jv
zC
zS
zS
zS
zS
zS
zS
zS
tw
tw
tw
tw
YZ
Oj
YZ
zS
zS
zS
zS
zS
"}
(25,1,1) = {"
zC
ur
jI
Jv
em
Jv
zC
zS
zS
zS
zS
zS
zS
zS
tw
zS
tw
zS
YZ
YZ
YZ
zS
zS
zS
zS
zS
"}
(26,1,1) = {"
iA
tM
pj
zC
to
to
to
zS
zS
zS
zS
zS
zS
zS
tw
zS
tw
zS
zS
Rh
zS
zS
zS
zS
zS
zS
"}
(27,1,1) = {"
ZT
ZT
ZT
Un
Un
CB
to
zS
zS
zS
zS
zS
zS
zS
tw
zS
tw
tw
Rh
Rh
Rh
Rh
zS
zS
zS
zS
"}
(28,1,1) = {"
ZT
ZT
ZT
sn
Un
Un
to
zS
zS
zS
zS
zS
zS
zS
tw
zS
Rh
zS
Rh
Oj
YZ
zS
zS
zS
zS
zS
"}
(29,1,1) = {"
ZT
ZT
ZT
XX
Hu
Un
to
zS
zS
zS
zS
zS
zS
zS
Rh
Rh
Rh
Rh
Rh
Oj
YZ
zS
zS
zS
zS
zS
"}
